Rk,Player,Pos,Age,Tm,G,GS,MP,FG,FGA,FG%,3P,3PA,3P%,2P,2PA,2P%,eFG%,FT,FTA,FT%,ORB,DRB,TRB,AST,STL,BLK,TOV,PF,PTS▼
1,Kevin Durant\duranke01,PF,33,BRK,34,34,1271,368,711,.518,63,174,.362,305,537,.568,.562,215,241,.892,20,242,262,196,25,33,105,65,1014
2,Trae Young\youngtr01,PG,23,ATL,35,35,1213,337,740,.455,95,257,.370,242,483,.501,.520,212,236,.898,27,114,141,335,33,4,144,58,981
3,Giannis Antetokounmpo\antetgi01,PF,27,MIL,34,34,1105,339,627,.541,38,134,.284,301,493,.611,.571,250,357,.700,64,325,389,204,36,49,114,108,966
4,Stephen Curry\curryst01,PG,33,GSW,36,36,1252,312,740,.422,184,475,.387,128,265,.483,.546,158,172,.919,23,169,192,217,51,19,124,75,966
5,Donovan Mitchell\mitchdo01,SG,25,UTA,37,37,1235,349,768,.454,121,349,.347,228,419,.544,.533,140,159,.881,32,108,140,191,60,8,111,93,959
6,Jayson Tatum\tatumja01,SF,23,BOS,37,37,1359,326,784,.416,102,312,.327,224,472,.475,.481,189,225,.840,42,272,314,138,37,29,106,92,943
7,Zach LaVine\lavinza01,SF,26,CHI,35,35,1226,332,675,.492,108,263,.411,224,412,.544,.572,144,166,.867,11,159,170,145,21,12,101,58,916
8,DeMar DeRozan\derozde01,PF,32,CHI,34,34,1193,323,658,.491,25,71,.352,298,587,.508,.510,225,264,.852,25,145,170,160,29,12,72,80,896
9,Nikola Jokić\jokicni01,C,26,DEN,33,33,1079,333,594,.561,50,141,.355,283,453,.625,.603,137,178,.770,90,378,468,230,45,27,119,81,853
10,LeBron James\jamesle01,SF,37,LAL,29,29,1067,313,593,.528,84,226,.372,229,367,.624,.599,128,163,.785,33,183,216,192,50,33,96,68,838
11,Bradley Beal\bealbr01,SG,28,WAS,34,34,1224,309,679,.455,56,188,.298,253,491,.515,.496,142,169,.840,33,126,159,217,30,12,114,83,816
12,Karl-Anthony Towns\townska01,C,26,MIN,33,33,1131,287,558,.514,77,181,.425,210,377,.557,.583,159,193,.824,97,210,307,122,34,39,117,123,810
13,De'Aaron Fox\foxde01,PG,24,SAC,39,39,1333,300,667,.450,36,146,.247,264,521,.507,.477,171,228,.750,19,124,143,198,49,17,108,112,807
14,Russell Westbrook\westbru01,PG,33,LAL,41,41,1453,295,665,.444,42,141,.298,253,524,.483,.475,145,222,.653,56,276,332,336,46,12,184,128,777
15,Domantas Sabonis\sabondo01,C,25,IND,40,39,1395,283,490,.578,31,96,.323,252,394,.640,.609,167,224,.746,130,351,481,185,41,16,124,122,764
16,James Harden\hardeja01,PG,32,BRK,34,34,1253,222,532,.417,80,242,.331,142,290,.490,.492,239,275,.869,32,243,275,331,45,23,164,85,763
17,Miles Bridges\bridgmi02,PF,23,CHO,39,39,1400,287,603,.476,73,230,.317,214,373,.574,.536,114,151,.755,52,232,284,142,45,32,69,98,761
18,Anthony Edwards\edwaran01,SG,20,MIN,34,34,1204,278,630,.441,108,295,.366,170,335,.507,.527,92,117,.786,37,150,187,125,54,25,109,81,756
19,Devin Booker\bookede01,SG,25,PHO,32,32,1048,271,616,.440,84,205,.410,187,411,.455,.508,129,147,.878,27,146,173,143,31,10,85,78,755
20,Joel Embiid\embiijo01,C,27,PHI,28,28,923,240,502,.478,35,91,.385,205,411,.499,.513,240,295,.814,54,244,298,122,32,40,79,70,755
21,Fred VanVleet\vanvlfr01,PG,27,TOR,34,34,1276,260,588,.442,130,318,.409,130,270,.481,.553,99,111,.892,28,142,170,227,56,19,91,80,749
22,Shai Gilgeous-Alexander\gilgesh01,PG,23,OKC,34,34,1188,252,617,.408,57,206,.277,195,411,.474,.455,183,222,.824,21,137,158,175,33,26,81,78,744
23,Julius Randle\randlju01,PF,27,NYK,39,39,1384,269,647,.416,68,218,.312,201,429,.469,.468,136,178,.764,69,328,397,189,30,23,135,108,742
24,Bojan Bogdanović\bogdabo02,PF,32,UTA,40,40,1219,247,511,.483,105,256,.410,142,255,.557,.586,127,147,.864,31,136,167,64,19,1,69,66,726
25,Desmond Bane\banede01,SF,23,MEM,41,41,1224,277,585,.474,122,285,.428,155,300,.517,.578,48,54,.889,20,164,184,98,44,20,60,103,724
26,Ja Morant\moranja01,PG,22,MEM,29,29,934,266,543,.490,46,120,.383,220,423,.520,.532,139,181,.768,38,128,166,193,40,12,92,37,717
27,Tyler Herro\herroty01,SG,22,MIA,34,10,1116,262,613,.427,92,237,.388,170,376,.452,.502,86,99,.869,23,145,168,133,20,5,98,49,702
28,Brandon Ingram\ingrabr01,SF,24,NOP,31,31,1072,255,576,.443,48,146,.329,207,430,.481,.484,141,172,.820,25,166,191,153,18,10,84,62,699
29,Damian Lillard\lillada01,PG,31,POR,29,29,1056,222,552,.402,92,284,.324,130,268,.485,.486,159,181,.878,13,107,120,212,17,11,83,37,695
30,Jonas Valančiūnas\valanjo01,C,29,NOP,37,37,1172,264,506,.522,38,89,.427,226,417,.542,.559,123,149,.826,130,317,447,88,21,35,89,115,689
31,LaMelo Ball\ballla01,PG,20,CHO,35,35,1114,247,583,.424,97,256,.379,150,327,.459,.507,89,102,.873,57,199,256,267,58,15,107,107,680
32,Darius Garland\garlada01,PG,22,CLE,35,35,1202,255,544,.469,92,242,.380,163,302,.540,.553,76,84,.905,17,89,106,257,45,3,128,58,678
33,Gordon Hayward\haywago01,SF,31,CHO,40,40,1328,243,527,.461,70,185,.378,173,342,.506,.528,122,142,.859,33,160,193,147,35,21,69,68,678
34,Jaren Jackson Jr.\jacksja02,PF,22,MEM,41,41,1128,226,552,.409,74,236,.314,152,316,.481,.476,145,173,.838,54,172,226,47,42,82,69,140,671
35,Christian Wood\woodch01,C,26,HOU,39,38,1200,246,516,.477,62,182,.341,184,334,.551,.537,112,183,.612,71,319,390,83,26,35,67,91,666
36,Kelly Oubre Jr.\oubreke01,SF,26,CHO,40,10,1128,243,530,.458,116,311,.373,127,219,.580,.568,62,92,.674,39,118,157,49,44,14,43,98,664
37,Buddy Hield\hieldbu01,SG,29,SAC,43,6,1256,221,566,.390,154,405,.380,67,161,.416,.527,67,77,.870,28,137,165,88,39,14,67,87,663
38,Andrew Wiggins\wiggian01,SF,26,GSW,35,35,1104,244,502,.486,77,184,.418,167,318,.525,.563,93,132,.705,41,113,154,65,34,21,56,61,658
39,Jaylen Brown\brownja02,SF,25,BOS,27,27,939,238,519,.459,75,204,.368,163,315,.517,.531,102,133,.767,24,155,179,81,31,14,83,72,653
40,Dejounte Murray\murrade01,PG,25,SAS,35,35,1200,270,612,.441,48,145,.331,222,467,.475,.480,57,79,.722,41,245,286,310,72,16,88,70,645
41,Franz Wagner\wagnefr01,SF,20,ORL,41,41,1317,241,533,.452,53,146,.363,188,387,.486,.502,108,128,.844,49,142,191,106,41,20,64,91,643
42,Paul George\georgpa01,SF,31,LAC,26,26,924,234,556,.421,70,217,.323,164,339,.484,.484,103,117,.880,11,174,185,142,53,10,109,65,641
43,Norman Powell\powelno01,SF,28,POR,34,34,1120,211,464,.455,75,188,.399,136,276,.493,.536,137,167,.820,14,84,98,73,34,15,52,77,634
44,Anthony Davis\davisan02,C,28,LAL,27,27,955,251,482,.521,10,56,.179,241,426,.566,.531,117,161,.727,74,193,267,77,32,55,60,63,629
45,Jalen Brunson\brunsja01,PG,25,DAL,39,21,1199,250,501,.499,41,122,.336,209,379,.551,.540,84,109,.771,23,120,143,218,33,2,65,72,625
46,Luka Dončić\doncilu01,PG,22,DAL,25,25,870,228,520,.438,64,201,.318,164,319,.514,.500,101,140,.721,17,189,206,225,29,11,116,61,621
47,Reggie Jackson\jacksre01,SG,31,LAC,37,37,1176,233,602,.387,96,286,.336,137,316,.434,.467,58,69,.841,19,107,126,144,27,5,81,70,620
48,Harrison Barnes\barneha02,PF,29,SAC,38,38,1264,189,423,.447,79,187,.422,110,236,.466,.540,155,188,.824,45,187,232,88,28,8,65,47,612
49,Jrue Holiday\holidjr01,PG,31,MIL,33,32,1094,245,491,.499,60,157,.382,185,334,.554,.560,56,79,.709,30,123,153,221,53,20,91,60,606
50,Jordan Clarkson\clarkjo01,SG,29,UTA,40,0,1030,222,556,.399,103,324,.318,119,232,.513,.492,58,73,.795,29,109,138,90,29,9,63,71,605
51,John Collins\collijo01,PF,24,ATL,34,34,1109,223,412,.541,44,103,.427,179,309,.579,.595,104,131,.794,64,205,269,67,23,39,38,102,594
52,Saddiq Bey\beysa01,SF,22,DET,39,39,1315,205,538,.381,91,273,.333,114,265,.430,.466,92,110,.836,56,190,246,96,37,7,58,67,593
53,Khris Middleton\middlkh01,SF,30,MIL,31,31,975,199,461,.432,72,191,.377,127,270,.470,.510,122,138,.884,22,149,171,163,34,6,100,71,592
54,Kyle Kuzma\kuzmaky01,PF,26,WAS,38,38,1263,218,492,.443,71,219,.324,147,273,.538,.515,73,106,.689,38,293,331,107,25,25,78,79,580
55,Terry Rozier\roziete01,SG,27,CHO,32,32,1023,213,487,.437,94,243,.387,119,244,.488,.534,60,74,.811,22,103,125,110,38,14,38,44,580
56,Jarrett Allen\allenja01,C,23,CLE,34,34,1110,235,336,.699,1,8,.125,234,328,.713,.701,103,146,.705,114,256,370,62,31,50,62,62,574
57,Rudy Gobert\goberru01,C,29,UTA,37,37,1187,202,286,.706,0,1,.000,202,285,.709,.706,170,249,.683,130,427,557,39,29,84,67,100,574
58,Jordan Poole\poolejo01,SG,22,GSW,33,29,984,200,448,.446,84,249,.337,116,199,.583,.540,89,100,.890,8,96,104,113,32,7,80,94,573
59,Seth Curry\curryse01,SG,31,PHI,35,35,1217,216,420,.514,78,190,.411,138,230,.600,.607,62,71,.873,15,101,116,136,27,5,64,80,572
60,Luguentz Dort\dortlu01,SF,22,OKC,35,35,1132,194,489,.397,83,268,.310,111,221,.502,.482,98,117,.838,23,120,143,59,32,14,56,101,569
61,Tyrese Haliburton\halibty01,SG,21,SAC,41,41,1393,214,457,.468,85,194,.438,129,263,.490,.561,55,68,.809,31,127,158,282,69,30,90,57,568
62,D'Angelo Russell\russeda01,PG,25,MIN,30,30,987,196,492,.398,88,255,.345,108,237,.456,.488,80,99,.808,12,103,115,207,28,16,78,61,560
63,Tobias Harris\harrito02,PF,29,PHI,30,30,1040,209,459,.455,33,112,.295,176,347,.507,.491,101,118,.856,34,192,226,117,16,19,50,59,552
64,RJ Barrett\barrerj01,SF,21,NYK,34,34,1074,197,480,.410,64,184,.348,133,296,.449,.477,92,133,.692,25,160,185,81,17,11,61,71,550
65,Chris Paul\paulch01,PG,36,PHO,39,39,1257,204,432,.472,38,116,.328,166,316,.525,.516,99,119,.832,14,157,171,390,73,10,90,83,545
66,Carmelo Anthony\anthoca01,PF,37,LAL,41,3,1108,184,431,.427,96,247,.389,88,184,.478,.538,77,96,.802,34,136,170,41,31,32,33,93,541
67,Dennis Schröder\schrode01,SG,28,BOS,34,19,1073,196,454,.432,47,144,.326,149,310,.481,.483,101,118,.856,19,96,115,155,27,3,78,84,540
68,Gary Trent Jr.\trentga02,SG,23,TOR,33,32,1122,201,477,.421,89,242,.368,112,235,.477,.515,49,58,.845,13,81,94,69,63,12,31,74,540
69,Tyrese Maxey\maxeyty01,PG,21,PHI,32,31,1105,204,431,.473,41,108,.380,163,323,.505,.521,88,101,.871,13,98,111,143,22,18,40,71,537
70,Cole Anthony\anthoco01,PG,21,ORL,27,27,919,183,451,.406,72,207,.348,111,244,.455,.486,98,114,.860,14,150,164,155,24,6,73,70,536
71,Kristaps Porziņģis\porzikr01,PF,26,DAL,26,26,791,187,415,.451,40,142,.282,147,273,.538,.499,121,137,.883,56,151,207,61,20,44,38,61,535
72,Derrick White\whitede01,SG,27,SAS,37,37,1130,186,440,.423,57,194,.294,129,246,.524,.488,106,122,.869,19,111,130,202,44,34,61,83,535
73,Jimmy Butler\butleji01,SF,32,MIA,23,23,777,180,360,.500,11,44,.250,169,316,.535,.515,162,186,.871,43,92,135,124,45,9,45,31,533
74,Evan Fournier\fournev01,SG,29,NYK,39,39,1124,192,464,.414,105,272,.386,87,192,.453,.527,43,58,.741,18,92,110,69,36,9,52,76,532
75,Keldon Johnson\johnske04,SF,22,SAS,36,36,1111,200,442,.452,56,127,.441,144,315,.457,.516,72,105,.686,39,195,234,61,30,4,50,68,528
76,Bobby Portis\portibo01,C,26,MIL,34,29,965,201,418,.481,65,152,.428,136,266,.511,.559,56,71,.789,97,216,313,46,26,28,56,93,523
77,Devonte' Graham\grahade01,PG,26,NOP,37,37,1159,172,462,.372,113,314,.360,59,148,.399,.495,62,76,.816,15,76,91,167,38,7,59,56,519
78,Myles Turner\turnemy01,C,25,IND,40,40,1183,190,370,.514,61,175,.349,129,195,.662,.596,76,101,.752,60,226,286,43,25,115,54,113,517
79,Will Barton\bartowi01,SG,31,DEN,34,34,1116,196,464,.422,79,219,.361,117,245,.478,.508,42,52,.808,22,146,168,144,30,15,64,49,513
80,Patty Mills\millspa02,PG,33,BRK,39,23,1210,180,421,.428,122,296,.412,58,125,.464,.572,26,29,.897,10,70,80,103,25,11,43,55,508
81,Mike Conley\conlemi01,PG,34,UTA,36,36,1025,179,387,.463,87,205,.424,92,182,.505,.575,58,71,.817,21,88,109,196,40,10,57,62,503
82,Eric Gordon\gordoer01,SG,33,HOU,35,24,1019,177,362,.489,79,181,.436,98,181,.541,.598,70,95,.737,7,52,59,118,21,16,79,36,503
83,Jusuf Nurkić\nurkiju01,C,27,POR,37,37,980,191,353,.541,8,35,.229,183,318,.575,.552,111,155,.716,90,289,379,98,42,19,82,121,501
84,Caris LeVert\leverca01,SG,27,IND,28,28,850,190,441,.431,44,142,.310,146,299,.488,.481,74,93,.796,18,74,92,112,29,15,49,59,498
85,Jae'Sean Tate\tateja01,SF,26,HOU,40,39,1090,194,395,.491,32,107,.299,162,288,.563,.532,76,109,.697,69,160,229,121,34,24,72,144,496
86,Pascal Siakam\siakapa01,PF,27,TOR,24,24,853,187,392,.477,28,83,.337,159,309,.515,.513,93,126,.738,50,151,201,108,22,19,59,78,495
87,Anfernee Simons\simonan01,SG,22,POR,35,8,911,180,406,.443,85,217,.392,95,189,.503,.548,50,53,.943,19,74,93,103,14,5,51,71,495
88,Malik Beasley\beaslma01,SG,25,MIN,40,9,1085,178,482,.369,118,350,.337,60,132,.455,.492,20,27,.741,14,113,127,67,25,5,33,48,494
89,Malcolm Brogdon\brogdma01,PG,29,IND,26,26,891,174,390,.446,46,148,.311,128,242,.529,.505,100,117,.855,24,115,139,158,23,11,58,54,494
90,Tim Hardaway Jr.\hardati02,SG,29,DAL,34,20,1042,175,445,.393,84,252,.333,91,193,.472,.488,60,81,.741,13,122,135,82,34,6,24,59,494
91,Kyle Lowry\lowryky01,PG,35,MIA,36,36,1235,166,393,.422,75,231,.325,91,162,.562,.518,87,103,.845,23,139,162,303,35,13,114,98,494
92,CJ McCollum\mccolcj01,SG,30,POR,24,24,848,191,451,.424,77,196,.393,114,255,.447,.509,35,50,.700,27,72,99,107,26,17,46,51,494
93,Nickeil Alexander-Walker\alexani01,SG,23,NOP,37,18,1003,185,502,.369,77,247,.312,108,255,.424,.445,45,62,.726,32,99,131,94,33,12,59,67,492
94,Evan Mobley\mobleev01,PF,20,CLE,33,33,1123,200,399,.501,15,51,.294,185,348,.532,.520,75,102,.735,55,211,266,85,28,58,58,71,490
95,Wendell Carter Jr.\cartewe01,C,22,ORL,37,37,1086,183,374,.489,46,139,.331,137,235,.583,.551,73,101,.723,80,300,380,100,26,24,60,102,485
96,Mikal Bridges\bridgmi01,SF,25,PHO,39,39,1325,193,371,.520,58,143,.406,135,228,.592,.598,39,46,.848,38,116,154,70,50,18,31,77,483
97,Aaron Gordon\gordoaa01,PF,26,DEN,35,35,1112,188,361,.521,33,105,.314,155,256,.605,.566,74,104,.712,60,131,191,76,22,22,56,66,483
98,Jerami Grant\grantje01,PF,27,DET,24,24,797,158,382,.414,42,127,.331,116,255,.455,.469,124,146,.849,23,93,116,62,27,27,51,54,482
99,Montrezl Harrell\harremo01,C,28,WAS,33,3,838,180,279,.645,3,10,.300,177,269,.658,.651,115,155,.742,72,170,242,73,17,20,38,63,478
100,Nikola Vučević\vucevni01,C,31,CHI,30,30,1001,198,465,.426,50,148,.338,148,317,.467,.480,28,42,.667,58,288,346,102,32,34,45,67,474
101,Alec Burks\burksal01,SG,30,NYK,40,16,1102,146,372,.392,77,189,.407,69,183,.377,.496,103,126,.817,21,148,169,95,52,11,37,90,472
102,Scottie Barnes\barnesc01,PF,20,TOR,32,32,1137,188,390,.482,24,74,.324,164,316,.519,.513,70,98,.714,92,163,255,112,33,29,62,91,470
103,Cade Cunningham\cunnica01,PG,20,DET,30,30,974,174,448,.388,67,209,.321,107,239,.448,.463,55,65,.846,27,144,171,163,40,19,112,85,470
104,Kevin Love\loveke01,PF,33,CLE,33,2,711,144,334,.431,85,207,.411,59,127,.465,.558,96,109,.881,38,207,245,69,11,8,40,34,469
105,Cameron Johnson\johnsca02,PF,25,PHO,39,6,1000,160,349,.458,99,226,.438,61,123,.496,.600,47,57,.825,25,141,166,50,33,10,27,63,466
106,Chris Duarte\duartch01,SG,24,IND,34,25,974,171,394,.434,62,176,.352,109,218,.500,.513,41,58,.707,20,115,135,71,34,5,57,59,445
107,Monte Morris\morrimo01,PG,26,DEN,35,34,1046,182,378,.481,60,153,.392,122,225,.542,.561,21,29,.724,11,84,95,147,25,5,42,50,445
108,Ricky Rubio\rubiori01,PG,31,CLE,34,8,970,149,411,.363,59,174,.339,90,237,.380,.434,88,103,.854,15,126,141,225,49,7,90,75,445
109,Duncan Robinson\robindu01,SG,27,MIA,37,35,1042,152,390,.390,116,323,.359,36,67,.537,.538,24,30,.800,15,111,126,55,25,8,26,99,444
110,Marcus Smart\smartma01,PG,27,BOS,38,38,1294,153,389,.393,55,181,.304,98,208,.471,.464,79,99,.798,24,127,151,201,74,11,77,94,440
111,Pat Connaughton\connapa01,SG,29,MIL,40,15,1125,156,331,.471,94,238,.395,62,93,.667,.613,26,33,.788,29,155,184,55,39,13,28,50,432
112,Malik Monk\monkma01,SG,23,LAL,36,9,936,159,337,.472,76,192,.396,83,145,.572,.585,38,45,.844,16,87,103,80,26,17,46,53,432
113,Grayson Allen\allengr01,SG,26,MIL,36,35,1023,147,355,.414,98,252,.389,49,103,.476,.552,35,41,.854,16,105,121,48,28,14,23,52,427
114,Kentavious Caldwell-Pope\caldwke01,SG,28,WAS,37,37,1100,153,363,.421,78,201,.388,75,162,.463,.529,42,48,.875,18,115,133,62,44,15,48,68,426
115,Clint Capela\capelca01,C,27,ATL,36,36,1068,190,334,.569,0,1,.000,190,333,.571,.569,45,97,.464,150,320,470,52,29,54,21,90,425
116,Lauri Markkanen\markkla01,PF,24,CLE,32,32,972,155,375,.413,59,191,.309,96,184,.522,.492,56,65,.862,36,134,170,53,22,17,27,57,425
117,Lonnie Walker IV\walkelo01,SG,23,SAS,36,5,820,155,390,.397,58,188,.309,97,202,.480,.472,55,65,.846,8,97,105,86,21,9,39,47,423
118,Terrence Ross\rosste01,SG,30,ORL,33,0,868,144,346,.416,48,157,.306,96,189,.508,.486,85,97,.876,13,79,92,72,21,7,51,45,421
119,Deandre Ayton\aytonde01,C,23,PHO,25,25,769,185,294,.629,1,7,.143,184,287,.641,.631,49,72,.681,71,204,275,40,19,21,42,54,420
120,Terance Mann\mannte01,SF,25,LAC,40,14,1184,161,332,.485,42,112,.375,119,220,.541,.548,56,75,.747,59,156,215,96,22,5,44,91,420
121,OG Anunoby\anunoog01,SF,24,TOR,22,22,788,153,349,.438,57,155,.368,96,194,.495,.520,56,67,.836,31,84,115,53,36,9,34,62,419
122,Eric Bledsoe\bledser01,PG,32,LAC,41,29,1093,155,363,.427,39,125,.312,116,238,.487,.481,70,90,.778,21,125,146,166,54,16,92,66,419
123,Lonzo Ball\balllo01,PG,24,CHI,32,32,1130,148,356,.416,100,239,.418,48,117,.410,.556,17,22,.773,31,144,175,163,60,29,75,77,413
124,Dorian Finney-Smith\finnedo01,PF,28,DAL,39,39,1253,151,332,.455,78,201,.388,73,131,.557,.572,31,47,.660,61,124,185,77,47,22,37,91,411
125,Jalen Green\greenja05,SG,19,HOU,27,27,816,137,341,.402,56,174,.322,81,167,.485,.484,81,99,.818,9,73,82,57,16,5,69,39,411
126,Luke Kennard\kennalu01,SG,25,LAC,35,10,1015,142,329,.432,97,220,.441,45,109,.413,.579,29,33,.879,6,113,119,72,24,5,27,56,410
127,Jakob Poeltl\poeltja01,C,26,SAS,33,32,941,190,320,.594,0,0,,190,320,.594,.594,29,80,.363,136,157,293,90,22,46,54,101,409
128,Spencer Dinwiddie\dinwisp01,PG,28,WAS,31,31,935,138,351,.393,52,157,.331,86,194,.443,.467,79,101,.782,25,125,150,175,16,5,52,74,407
129,Cam Reddish\reddica01,SF,22,ATL,34,7,797,138,343,.402,58,153,.379,80,190,.421,.487,72,80,.900,20,64,84,38,35,11,44,45,406
130,Josh Hart\hartjo01,PF,26,NOP,31,30,1017,145,281,.516,31,91,.341,114,190,.600,.571,79,104,.760,40,189,229,137,28,11,61,91,400
131,Gary Harris\harriga01,SG,27,ORL,34,24,996,145,322,.450,58,156,.372,87,166,.524,.540,48,57,.842,26,54,80,64,29,8,45,70,396
132,Immanuel Quickley\quickim01,PG,22,NYK,37,2,846,131,332,.395,68,194,.351,63,138,.457,.497,66,71,.930,13,73,86,99,23,3,44,79,396
133,Dillon Brooks\brookdi01,SF,26,MEM,21,20,587,145,340,.426,33,101,.327,112,239,.469,.475,64,72,.889,17,52,69,57,27,4,37,69,387
134,LaMarcus Aldridge\aldrila01,C,36,BRK,29,10,663,165,292,.565,12,35,.343,153,257,.595,.586,44,52,.846,43,120,163,23,11,32,25,48,386
135,Josh Giddey\giddejo01,SG,19,OKC,34,34,1034,155,391,.396,35,126,.278,120,265,.453,.441,32,47,.681,51,203,254,216,35,17,98,59,377
136,Kevin Huerter\huertke01,SG,23,ATL,32,20,907,145,309,.469,57,154,.370,88,155,.568,.561,18,23,.783,11,99,110,86,15,8,43,63,365
137,Daniel Gafford\gaffoda01,C,23,WAS,37,37,848,155,224,.692,0,0,,155,224,.692,.692,52,71,.732,90,161,251,40,16,67,39,93,362
138,JaVale McGee\mcgeeja01,C,34,PHO,35,10,561,151,231,.654,1,4,.250,150,227,.661,.656,54,78,.692,81,170,251,23,11,29,55,92,357
139,Justin Holiday\holidju01,SF,32,IND,35,26,994,123,315,.390,84,237,.354,39,78,.500,.524,26,31,.839,9,91,100,55,22,9,36,74,356
140,Devin Vassell\vassede01,SF,21,SAS,32,4,801,140,309,.453,54,154,.351,86,155,.555,.540,22,30,.733,22,103,125,47,31,23,26,62,356
141,Georges Niang\niangge01,PF,28,PHI,35,5,807,127,286,.444,70,176,.398,57,110,.518,.566,30,35,.857,11,83,94,46,18,8,26,88,354
142,Cameron Payne\payneca01,PG,27,PHO,34,0,696,132,340,.388,38,118,.322,94,222,.423,.444,51,59,.864,15,84,99,124,22,11,65,65,353
143,Jeff Green\greenje02,C,35,DEN,35,24,867,126,248,.508,28,84,.333,98,164,.598,.565,72,90,.800,16,90,106,41,10,18,36,82,352
144,Frank Jackson\jacksfr01,PG,23,DET,33,5,749,123,305,.403,62,186,.333,61,119,.513,.505,44,53,.830,11,40,51,31,16,8,27,54,352
145,Ivica Zubac\zubaciv01,C,24,LAC,37,37,920,133,201,.662,0,0,,133,201,.662,.662,86,116,.741,102,206,308,41,19,42,49,86,352
146,Al Horford\horfoal01,C,35,BOS,32,32,943,127,295,.431,39,137,.285,88,158,.557,.497,55,64,.859,50,194,244,120,23,47,37,68,348
147,Hamidou Diallo\diallha01,SG,23,DET,32,15,704,143,275,.520,13,49,.265,130,226,.575,.544,42,69,.609,33,109,142,44,41,13,36,75,341
148,Richaun Holmes\holmeri01,C,28,SAC,27,27,706,144,208,.692,2,4,.500,142,204,.696,.697,50,62,.806,67,168,235,35,8,28,39,84,340
149,Bam Adebayo\adebaba01,C,24,MIA,18,18,592,126,243,.519,0,1,.000,126,242,.521,.519,85,112,.759,49,134,183,57,20,6,53,59,337
150,Naz Reid\reidna01,C,22,MIN,37,5,627,124,266,.466,32,95,.337,92,171,.538,.526,57,79,.722,57,94,151,28,19,36,37,87,337
151,Davion Mitchell\mitchda01,PG,23,SAC,37,1,917,136,350,.389,42,138,.304,94,212,.443,.449,22,34,.647,17,63,80,118,23,7,36,67,336
152,Tyus Jones\jonesty01,PG,25,MEM,41,13,876,132,281,.470,38,102,.373,94,179,.525,.537,33,36,.917,11,99,110,169,36,2,32,19,335
153,Max Strus\strusma01,SF,25,MIA,29,5,675,117,249,.470,76,182,.418,41,67,.612,.622,25,33,.758,10,91,101,35,10,2,21,42,335
154,Cedi Osman\osmande01,SF,26,CLE,29,0,664,116,256,.453,66,166,.398,50,90,.556,.582,34,49,.694,12,66,78,51,30,8,26,52,332
155,De'Anthony Melton\meltode01,SG,23,MEM,33,13,787,121,306,.395,52,161,.323,69,145,.476,.480,36,48,.750,33,116,149,96,54,22,56,61,330
156,Trey Lyles\lylestr01,PF,26,DET,36,3,676,113,256,.441,32,107,.299,81,149,.544,.504,71,88,.807,47,123,170,42,14,14,36,63,329
157,Marcus Morris\morrima03,PF,32,LAC,20,20,602,117,264,.443,41,107,.383,76,157,.484,.521,53,59,.898,13,90,103,44,9,5,26,45,328
158,Bryn Forbes\forbebr01,SG,28,SAS,38,1,627,116,273,.425,53,135,.393,63,138,.457,.522,42,47,.894,4,57,61,38,15,3,33,37,327
159,Kemba Walker\walkeke02,PG,31,NYK,24,24,654,113,273,.414,58,144,.403,55,129,.426,.520,42,50,.840,11,74,85,87,20,5,33,28,326
160,Mo Bamba\bambamo01,C,23,ORL,32,32,899,129,288,.448,41,123,.333,88,165,.533,.519,23,30,.767,72,198,270,49,26,66,43,81,322
161,Furkan Korkmaz\korkmfu01,SG,24,PHI,35,11,808,116,300,.387,52,172,.302,64,128,.500,.473,36,44,.818,12,101,113,79,22,4,30,30,320
162,Kenyon Martin Jr.\martike04,SF,21,HOU,39,0,737,127,241,.527,23,70,.329,104,171,.608,.575,43,66,.652,40,105,145,52,16,21,26,48,320
163,Nassir Little\littlna01,SF,21,POR,35,16,884,113,253,.447,39,123,.317,74,130,.569,.524,54,75,.720,49,148,197,41,23,31,31,74,319
164,Kevin Porter Jr.\porteke02,PG,21,HOU,26,26,773,109,305,.357,47,146,.322,62,159,.390,.434,53,87,.609,21,92,113,151,33,9,99,66,318
165,Robert Williams\williro04,C,24,BOS,32,32,939,141,188,.750,0,0,,141,188,.750,.750,36,54,.667,123,164,287,55,28,70,39,63,318
166,Herbert Jones\joneshe01,C,23,NOP,37,28,1067,123,259,.475,20,57,.351,103,202,.510,.514,50,62,.806,47,93,140,69,54,38,41,111,316
167,Bogdan Bogdanović\bogdabo01,SG,29,ATL,26,24,749,117,280,.418,58,158,.367,59,122,.484,.521,23,31,.742,8,89,97,65,19,5,25,48,315
168,Alperen Şengün\sengual01,C,19,HOU,35,2,644,110,220,.500,12,39,.308,98,181,.541,.527,83,118,.703,60,107,167,92,32,30,68,108,315
169,Derrick Rose\rosede01,PG,33,NYK,26,4,636,122,274,.445,37,92,.402,85,182,.467,.513,30,31,.968,21,57,78,103,22,12,39,15,311
170,Josh Richardson\richajo01,SG,28,BOS,29,0,756,109,239,.456,41,101,.406,68,138,.493,.542,49,58,.845,18,60,78,41,26,14,23,60,308
171,Cody Martin\martico01,SF,26,CHO,36,5,964,112,233,.481,39,82,.476,73,151,.483,.564,42,58,.724,45,103,148,98,53,18,30,61,305
172,Jaden McDaniels\mcdanja02,PF,21,MIN,37,17,978,122,287,.425,37,129,.287,85,158,.538,.490,22,28,.786,52,116,168,39,31,23,39,129,303
173,Jordan Nwora\nworajo01,SF,23,MIL,33,9,698,116,276,.420,55,141,.390,61,135,.452,.520,14,17,.824,25,110,135,36,16,13,35,39,301
174,Jae Crowder\crowdja01,PF,31,PHO,33,33,926,104,261,.398,59,175,.337,45,86,.523,.511,33,42,.786,12,141,153,45,39,17,30,78,300
175,Gary Payton II\paytoga02,PG,29,GSW,38,8,640,124,192,.646,28,67,.418,96,125,.768,.719,23,39,.590,43,96,139,30,51,9,19,62,299
176,Darius Bazley\bazleda01,PF,21,OKC,34,27,898,112,291,.385,31,116,.267,81,175,.463,.438,43,69,.623,38,175,213,40,26,44,50,31,298
177,Doug McDermott\mcderdo01,PF,30,SAS,26,26,640,113,243,.465,55,134,.410,58,109,.532,.578,16,22,.727,10,58,68,35,4,2,19,36,297
178,Hassan Whiteside\whiteha01,C,32,UTA,36,3,589,117,187,.626,0,0,,117,187,.626,.626,61,89,.685,82,164,246,12,9,48,33,103,295
179,Chris Boucher\bouchch01,PF,29,TOR,35,7,620,106,241,.440,23,98,.235,83,143,.580,.488,58,76,.763,64,119,183,13,22,32,24,64,293
180,Danilo Gallinari\gallida01,PF,33,ATL,30,1,667,93,227,.410,46,116,.397,47,111,.423,.511,61,65,.938,18,107,125,42,14,6,16,42,293
181,Garrison Mathews\mathega01,SG,25,HOU,25,16,714,87,208,.418,64,173,.370,23,35,.657,.572,55,69,.797,14,76,90,22,17,11,18,77,293
182,Obi Toppin\toppiob01,PF,23,NYK,36,2,586,111,210,.529,12,59,.203,99,151,.656,.557,55,70,.786,38,99,137,38,12,18,30,55,289
183,Deni Avdija\avdijde01,SF,21,WAS,40,5,924,105,247,.425,34,114,.298,71,133,.534,.494,44,61,.721,29,169,198,61,31,29,36,93,288
184,Dwight Powell\poweldw01,C,30,DAL,40,37,813,107,177,.605,12,29,.414,95,148,.642,.638,59,82,.720,81,103,184,45,20,15,29,95,285
185,Mitchell Robinson\robinmi01,C,23,NYK,37,28,922,120,153,.784,0,0,,120,153,.784,.784,45,81,.556,126,172,298,17,19,60,28,98,285
186,Shake Milton\miltosh01,PG,25,PHI,27,6,668,109,254,.429,25,79,.316,84,175,.480,.478,41,48,.854,13,68,81,75,20,11,31,56,284
187,Kyle Anderson\anderky01,PF,28,MEM,34,6,767,110,252,.437,24,71,.338,86,181,.475,.484,37,55,.673,29,152,181,91,36,20,35,52,281
188,Royce O'Neale\onealro01,SF,28,UTA,38,38,1191,102,208,.490,54,135,.400,48,73,.658,.620,22,31,.710,33,154,187,95,51,20,37,94,280
189,Steven Adams\adamsst01,C,28,MEM,40,40,1026,105,198,.530,0,0,,105,198,.530,.530,69,115,.600,172,203,375,119,33,23,64,66,279
190,P.J. Tucker\tuckepj01,PF,36,MIA,34,33,970,104,208,.500,46,98,.469,58,110,.527,.611,23,33,.697,59,134,193,76,25,11,33,78,277
191,Gabe Vincent\vincega01,PG,25,MIA,32,10,698,100,230,.435,52,139,.374,48,91,.527,.548,24,31,.774,15,52,67,94,26,7,48,69,276
192,R.J. Hampton\hamptrj01,SG,20,ORL,37,1,724,97,249,.390,37,98,.378,60,151,.397,.464,44,73,.603,13,94,107,92,22,7,50,57,275
193,Joe Ingles\inglejo01,SF,34,UTA,36,8,908,97,227,.427,67,178,.376,30,49,.612,.575,14,18,.778,12,94,106,129,20,5,44,67,275
194,Robert Covington\covinro01,PF,31,POR,37,29,1042,99,243,.407,62,175,.354,37,68,.544,.535,14,14,1.000,26,165,191,43,50,47,40,94,274
195,Talen Horton-Tucker\hortota01,SG,21,LAL,25,15,699,104,255,.408,20,82,.244,84,173,.486,.447,46,56,.821,19,80,99,69,25,11,39,71,274
196,Landry Shamet\shamela01,SG,24,PHO,35,7,723,92,242,.380,60,165,.364,32,77,.416,.504,30,36,.833,9,65,74,54,18,3,20,39,274
197,Draymond Green\greendr01,PF,31,GSW,34,34,1018,108,201,.537,12,42,.286,96,159,.604,.567,40,67,.597,38,219,257,250,47,41,106,94,268
198,Caleb Martin\martica02,SF,26,MIA,30,8,681,103,204,.505,30,81,.370,73,123,.593,.578,30,45,.667,33,76,109,30,28,17,22,46,266
199,Otto Porter Jr.\porteot01,PF,28,GSW,33,4,700,100,219,.457,51,131,.389,49,88,.557,.573,15,20,.750,36,131,167,48,33,15,19,44,266
200,Raul Neto\netora01,PG,29,WAS,34,0,697,103,231,.446,14,56,.250,89,175,.509,.476,41,55,.745,7,64,71,91,24,1,40,55,261
201,Grant Williams\willigr01,PF,23,BOS,36,11,825,87,182,.478,52,124,.419,35,58,.603,.621,35,39,.897,28,91,119,36,18,23,28,73,261
202,Brandon Clarke\clarkbr01,PF,25,MEM,28,0,485,113,175,.646,2,15,.133,111,160,.694,.651,32,49,.653,52,89,141,39,9,28,15,47,260
203,Mike Muscala\muscami01,C,30,OKC,32,0,446,83,184,.451,51,121,.421,32,63,.508,.590,42,48,.875,15,83,98,17,14,21,11,43,259
204,Jeremiah Robinson-Earl\robinje02,C,21,OKC,35,27,790,96,231,.416,40,118,.339,56,113,.496,.502,26,37,.703,60,139,199,30,19,10,31,53,258
205,Jalen Suggs\suggsja01,PG,20,ORL,21,21,583,87,257,.339,26,102,.255,61,155,.394,.389,58,76,.763,16,55,71,75,24,9,67,58,258
206,Nemanja Bjelica\bjeline01,C,33,GSW,39,0,587,94,208,.452,37,100,.370,57,108,.528,.541,31,46,.674,33,117,150,59,24,13,43,60,256
207,Larry Nance Jr.\nancela02,PF,29,POR,37,11,858,102,198,.515,19,62,.306,83,136,.610,.563,32,49,.653,58,151,209,73,38,13,27,67,255
208,P.J. Washington\washipj01,PF,23,CHO,24,3,601,89,195,.456,47,111,.423,42,84,.500,.577,30,43,.698,32,101,133,58,19,26,33,61,255
209,Kenrich Williams\willike04,SF,27,OKC,36,0,742,101,217,.465,29,76,.382,72,141,.511,.532,21,39,.538,49,95,144,68,35,5,30,62,252
210,Patrick Beverley\beverpa01,PG,33,MIN,27,23,720,90,212,.425,36,110,.327,54,102,.529,.509,33,47,.702,34,89,123,141,28,24,33,81,249
211,Facundo Campazzo\campafa01,PG,30,DEN,37,4,810,80,205,.390,44,129,.341,36,76,.474,.498,42,52,.808,14,65,79,148,42,18,46,81,246
212,Chimezie Metu\metuch01,C,24,SAC,27,16,615,94,230,.409,28,103,.272,66,127,.520,.470,28,36,.778,20,150,170,27,24,18,24,38,244
213,Isaac Okoro\okorois01,SF,21,CLE,27,23,767,89,196,.454,25,78,.321,64,118,.542,.518,41,57,.719,33,65,98,50,22,7,31,67,244
214,Josh Christopher\chrisjo01,SG,20,HOU,34,2,544,88,194,.454,26,75,.347,62,119,.521,.521,40,50,.800,22,45,67,59,29,3,52,38,242
215,Isaiah Stewart\stewais01,C,20,DET,31,31,791,103,195,.528,2,16,.125,101,179,.564,.533,32,48,.667,79,178,257,32,12,38,38,86,240
216,Armoni Brooks\brookar01,SG,23,HOU,33,8,599,81,221,.367,59,186,.317,22,35,.629,.500,16,18,.889,9,56,65,47,20,7,19,54,237
217,Garrett Temple\templga01,SG,35,NOP,38,12,752,83,205,.405,48,132,.364,35,73,.479,.522,22,30,.733,25,84,109,50,31,17,33,62,236
218,George Hill\hillge01,SG,35,MIL,33,12,845,85,191,.445,28,91,.308,57,100,.570,.518,36,38,.947,27,77,104,79,26,5,31,48,234
219,Damion Lee\leeda03,SG,29,GSW,28,2,580,85,193,.440,33,95,.347,52,98,.531,.526,30,35,.857,9,78,87,28,15,4,16,44,233
220,Kevon Looney\looneke01,C,25,GSW,39,39,779,100,185,.541,0,1,.000,100,184,.543,.541,33,56,.589,95,165,260,61,21,31,31,105,233
221,Rudy Gay\gayru01,PF,35,UTA,25,0,498,79,184,.429,40,106,.377,39,78,.500,.538,33,41,.805,24,92,116,27,13,7,19,47,231
222,Jalen McDaniels\mcdanja01,SF,24,CHO,34,2,608,86,171,.503,29,75,.387,57,96,.594,.588,29,44,.659,26,93,119,41,20,14,27,62,230
223,Jarred Vanderbilt\vandeja01,PF,22,MIN,35,28,892,98,172,.570,2,10,.200,96,162,.593,.576,32,49,.653,113,211,324,47,54,28,38,92,230
224,Avery Bradley\bradlav01,SG,31,LAL,33,28,784,87,202,.431,46,116,.397,41,86,.477,.545,7,7,1.000,17,67,84,26,31,8,16,61,227
225,Bones Hyland\hylanbo01,PG,21,DEN,28,0,473,78,217,.359,42,133,.316,36,84,.429,.456,28,32,.875,6,54,60,44,15,7,26,55,226
226,Josh Jackson\jacksjo02,SF,24,DET,30,3,551,86,206,.417,26,92,.283,60,114,.526,.481,28,41,.683,15,84,99,44,15,11,30,52,226
227,Svi Mykhailiuk\mykhasv01,SF,24,TOR,35,5,621,82,197,.416,35,108,.324,47,89,.528,.505,27,32,.844,18,65,83,40,23,4,26,46,226
228,Andre Drummond\drumman01,C,28,PHI,34,11,652,93,176,.528,0,1,.000,93,175,.531,.528,37,66,.561,104,208,312,68,38,35,56,82,223
229,Precious Achiuwa\achiupr01,C,22,TOR,28,17,686,92,227,.405,9,33,.273,83,194,.428,.425,29,51,.569,64,148,212,40,16,17,31,61,222
230,Isaiah Hartenstein\harteis01,C,23,LAC,29,0,477,94,142,.662,2,3,.667,92,139,.662,.669,32,49,.653,53,83,136,54,24,37,29,74,222
231,Alex Caruso\carusal01,SG,27,CHI,26,9,729,73,163,.448,28,77,.364,45,86,.523,.534,44,53,.830,25,72,97,103,53,9,39,66,218
232,Cory Joseph\josepco01,PG,30,DET,29,6,644,74,162,.457,25,60,.417,49,102,.480,.534,44,52,.846,8,53,61,106,23,5,42,50,217
233,Chuma Okeke\okekech01,PF,23,ORL,30,6,690,81,229,.354,29,124,.234,52,105,.495,.417,26,30,.867,20,110,130,43,38,12,28,42,217
234,Coby White\whiteco01,PG,21,CHI,19,6,472,78,173,.451,35,92,.380,43,81,.531,.552,26,34,.765,3,47,50,45,8,5,21,40,217
235,Reggie Bullock\bullore01,SF,30,DAL,33,13,801,77,203,.379,48,151,.318,29,52,.558,.498,13,17,.765,7,88,95,37,14,5,18,45,215
236,Terence Davis\daviste02,SG,24,SAC,24,7,399,79,197,.401,32,109,.294,47,88,.534,.482,23,28,.821,8,64,72,26,17,9,28,54,213
237,Dewayne Dedmon\dedmode01,C,32,MIA,33,15,568,84,146,.575,12,20,.600,72,126,.571,.616,33,44,.750,60,141,201,29,13,15,31,71,213
238,Ayo Dosunmu\dosunay01,SG,22,CHI,33,2,631,85,157,.541,24,53,.453,61,104,.587,.618,18,31,.581,13,58,71,42,15,11,31,55,212
239,Torrey Craig\craigto01,SF,31,IND,36,1,601,81,163,.497,24,75,.320,57,88,.648,.571,24,29,.828,43,81,124,37,14,10,24,60,210
240,Daniel Theis\theisda01,C,29,HOU,24,21,562,81,173,.468,22,76,.289,59,97,.608,.532,26,38,.684,31,95,126,19,11,16,30,58,210
241,Mason Plumlee\plumlma01,C,31,CHO,32,32,788,91,150,.607,0,1,.000,91,149,.611,.607,27,71,.380,76,152,228,90,28,28,37,93,209
242,Bruce Brown\brownbr01,SF,25,BRK,30,17,675,90,184,.489,10,30,.333,80,154,.519,.516,18,24,.750,39,96,135,38,37,15,21,82,208
243,Ty Jerome\jeromty01,SG,24,OKC,30,3,446,75,191,.393,29,100,.290,46,91,.505,.469,29,36,.806,14,33,47,49,19,3,23,41,208
244,Aaron Holiday\holidaa01,PG,25,WAS,33,10,551,84,178,.472,19,52,.365,65,126,.516,.525,19,24,.792,4,48,52,63,19,8,31,51,206
245,DeAndre' Bembry\bembrde01,SF,27,BRK,35,15,694,89,151,.589,12,26,.462,77,125,.616,.629,15,26,.577,24,87,111,43,36,19,23,75,205
246,Jaylen Nowell\nowelja01,SG,22,MIN,26,0,362,80,169,.473,20,58,.345,60,111,.541,.533,22,30,.733,8,44,52,53,16,5,14,26,202
247,JaMychal Green\greenja01,PF,31,DEN,34,6,505,73,165,.442,19,75,.253,54,90,.600,.500,36,42,.857,31,94,125,27,23,16,32,75,201
248,T.J. McConnell\mccontj01,PG,29,IND,24,6,581,91,181,.503,7,25,.280,84,156,.538,.522,12,15,.800,19,61,80,115,25,9,28,43,201
249,Moritz Wagner\wagnemo01,C,24,ORL,31,0,358,65,147,.442,29,86,.337,36,61,.590,.541,42,53,.792,16,57,73,26,6,7,23,59,201
250,Jeremy Lamb\lambje01,SF,29,IND,28,0,410,62,169,.367,28,84,.333,34,85,.400,.450,44,48,.917,12,59,71,37,13,10,15,32,196
251,Cam Thomas\thomaca02,SG,20,BRK,28,1,458,78,188,.415,18,73,.247,60,115,.522,.463,22,27,.815,5,62,67,33,15,4,20,17,196
252,Maxi Kleber\klebima01,PF,30,DAL,25,8,617,65,154,.422,43,115,.374,22,39,.564,.562,19,26,.731,29,123,152,27,11,22,17,56,192
253,Ben McLemore\mclembe01,SG,28,POR,23,2,363,65,149,.436,49,117,.419,16,32,.500,.601,13,15,.867,7,23,30,15,7,2,14,31,192
254,Derrick Jones Jr.\jonesde02,PF,24,CHI,29,6,519,69,119,.580,13,35,.371,56,84,.667,.634,39,46,.848,37,65,102,16,15,23,15,67,190
255,Wayne Ellington\ellinwa01,SG,34,LAL,28,8,580,64,157,.408,56,143,.392,8,14,.571,.586,4,5,.800,7,41,48,22,14,2,13,29,188
256,Corey Kispert\kispeco01,SF,22,WAS,35,4,593,67,162,.414,26,91,.286,41,71,.577,.494,28,33,.848,18,50,68,27,10,9,16,26,188
257,Danny Green\greenda02,SF,34,PHI,28,21,679,64,157,.408,51,135,.378,13,22,.591,.570,8,8,1.000,16,57,73,32,38,24,25,51,187
258,Alex Len\lenal01,C,28,SAC,27,9,481,75,142,.528,6,19,.316,69,123,.561,.549,31,46,.674,40,94,134,29,7,22,33,77,187
259,Oshae Brissett\brissos01,SF,23,IND,30,1,550,71,160,.444,28,74,.378,43,86,.500,.531,16,28,.571,39,75,114,23,16,10,20,42,186
260,Marvin Bagley III\baglema01,PF,22,SAC,23,10,481,72,172,.419,11,50,.220,61,122,.500,.451,30,40,.750,55,105,160,14,7,6,16,37,185
261,Tre Mann\manntr01,PG,20,OKC,26,2,436,72,181,.398,27,74,.365,45,107,.421,.472,14,22,.636,10,47,57,18,13,6,18,40,185
262,Tristan Thompson\thomptr01,PF,30,SAC,30,3,455,76,151,.503,1,1,1.000,75,150,.500,.507,32,60,.533,72,89,161,18,11,12,29,52,185
263,Nic Claxton\claxtni01,C,22,BRK,20,14,443,80,122,.656,0,0,,80,122,.656,.656,24,39,.615,38,71,109,19,11,23,15,50,184
264,Drew Eubanks\eubandr01,C,24,SAS,37,8,469,65,126,.516,1,6,.167,64,120,.533,.520,50,66,.758,42,105,147,40,12,25,40,53,181
265,Killian Hayes\hayeski01,PG,20,DET,29,29,747,65,191,.340,26,83,.313,39,108,.361,.408,25,29,.862,13,74,87,105,33,12,45,71,181
266,Nicolas Batum\batumni01,PF,33,LAC,22,18,561,66,137,.482,42,107,.393,24,30,.800,.635,6,12,.500,9,93,102,35,23,17,19,25,180
267,Jaxson Hayes\hayesja02,C,21,NOP,28,0,377,64,118,.542,4,14,.286,60,104,.577,.559,48,61,.787,37,64,101,10,8,18,18,51,180
268,Willy Hernangómez\hernawi01,C,27,NOP,23,3,342,70,125,.560,2,3,.667,68,122,.557,.568,36,51,.706,56,98,154,28,8,5,20,40,178
269,Juan Toscano-Anderson\toscaju01,SF,28,GSW,37,3,611,71,141,.504,11,46,.239,60,95,.632,.543,25,41,.610,22,88,110,81,29,13,41,61,178
270,Dāvis Bertāns\bertada01,PF,29,WAS,27,0,429,54,148,.365,42,123,.341,12,25,.480,.507,27,29,.931,6,47,53,15,11,3,13,47,177
271,Blake Griffin\griffbl01,PF,32,BRK,30,20,569,64,178,.360,18,84,.214,46,94,.489,.410,31,43,.721,34,100,134,59,16,11,14,63,177
272,David Nwaba\nwabada01,SF,29,HOU,33,4,469,67,141,.475,10,35,.286,57,106,.538,.511,33,47,.702,29,100,129,27,22,18,15,41,177
273,Collin Sexton\sextoco01,SG,23,CLE,11,11,316,68,151,.450,11,45,.244,57,106,.538,.487,29,39,.744,13,23,36,23,10,0,31,25,176
274,Matisse Thybulle\thybuma01,SG,24,PHI,30,15,781,73,148,.493,22,75,.293,51,73,.699,.568,8,9,.889,16,55,71,33,54,33,23,71,176
275,Lou Williams\willilo02,PG,35,ATL,27,0,388,63,172,.366,17,56,.304,46,116,.397,.416,33,39,.846,8,35,43,40,15,2,25,27,176
276,Keita Bates-Diop\bateske01,SF,26,SAS,32,11,539,71,136,.522,8,27,.296,63,109,.578,.551,24,36,.667,34,98,132,20,16,11,27,33,174
277,Omer Yurtseven\yurtsom01,C,23,MIA,31,7,459,73,156,.468,1,7,.143,72,149,.483,.471,26,41,.634,56,141,197,30,15,16,28,53,173
278,Kelan Martin\martike03,SF,26,IND,27,1,444,70,168,.417,22,74,.297,48,94,.511,.482,9,13,.692,16,37,53,21,13,9,14,36,171
279,Javonte Green\greenja02,SF,28,CHI,29,18,644,62,125,.496,12,33,.364,50,92,.543,.544,32,40,.800,44,79,123,28,24,12,17,62,168
280,Aleksej Pokusevski\pokusal01,PF,20,OKC,36,2,544,69,193,.358,20,87,.230,49,106,.462,.409,7,14,.500,33,112,145,40,18,17,42,44,165
281,Amir Coffey\coffeam01,SG,24,LAC,28,6,491,50,114,.439,27,71,.380,23,43,.535,.557,36,42,.857,10,65,75,32,8,6,9,30,163
282,D.J. Augustin\augusdj01,PG,34,HOU,31,2,464,49,122,.402,34,86,.395,15,36,.417,.541,30,34,.882,6,29,35,70,10,0,40,16,162
283,Austin Rivers\riverau01,SG,29,DEN,28,8,565,61,155,.394,32,99,.323,29,56,.518,.497,7,12,.583,10,39,49,29,14,2,21,41,161
284,Brandon Boston Jr.\bostobr01,SG,20,LAC,24,0,375,56,160,.350,16,58,.276,40,102,.392,.400,32,38,.842,7,44,51,19,16,6,18,17,160
285,Joe Harris\harrijo01,SF,30,BRK,14,14,423,56,124,.452,41,88,.466,15,36,.417,.617,5,6,.833,5,51,56,14,7,2,16,31,158
286,Dwight Howard\howardw01,C,36,LAL,31,6,456,57,94,.606,6,8,.750,51,86,.593,.638,37,60,.617,53,115,168,18,23,19,24,59,157
287,John Konchar\konchjo01,SG,25,MEM,34,2,562,60,111,.541,24,50,.480,36,61,.590,.649,13,23,.565,40,95,135,45,27,7,15,42,157
288,Romeo Langford\langfro01,SG,22,BOS,31,5,587,60,143,.420,20,62,.323,40,81,.494,.490,15,23,.652,28,67,95,17,19,12,12,40,155
289,Aaron Wiggins\wiggiaa01,SG,23,OKC,21,11,441,58,113,.513,17,50,.340,41,63,.651,.588,22,31,.710,13,50,63,25,14,5,16,39,155
290,DeMarcus Cousins\couside01,C,31,MIL,17,5,287,55,118,.466,13,48,.271,42,70,.600,.521,31,38,.816,24,74,98,18,16,8,16,46,154
291,Payton Pritchard\pritcpa01,SG,24,BOS,31,2,420,55,153,.359,35,98,.357,20,55,.364,.474,8,8,1.000,12,46,58,55,5,4,23,29,153
292,Derrick Favors\favorde01,C,30,OKC,29,12,468,70,140,.500,2,11,.182,68,129,.527,.507,10,18,.556,39,95,134,22,12,7,6,44,152
293,Xavier Tillman Sr.\tillmxa01,PF,23,MEM,30,0,434,58,130,.446,6,31,.194,52,99,.525,.469,29,42,.690,41,57,98,36,36,14,22,40,151
294,Tre Jones\jonestr01,PG,22,SAS,35,2,442,63,130,.485,2,13,.154,61,117,.521,.492,21,21,1.000,15,56,71,79,13,0,21,33,149
295,Frank Ntilikina\ntilila01,PG,23,DAL,30,5,437,52,140,.371,25,72,.347,27,68,.397,.461,19,19,1.000,6,40,46,45,21,3,20,37,148
296,Damian Jones\jonesda03,C,26,SAC,25,4,354,55,89,.618,3,11,.273,52,78,.667,.635,33,46,.717,38,68,106,19,3,11,26,50,146
297,Dean Wade\wadede01,PF,25,CLE,29,16,572,54,125,.432,26,79,.329,28,46,.609,.536,10,13,.769,23,75,98,35,15,2,11,46,144
298,Trey Burke\burketr01,PG,29,DAL,19,0,258,55,128,.430,16,49,.327,39,79,.494,.492,16,17,.941,2,20,22,40,8,0,16,19,142
299,Kira Lewis Jr.\lewiski01,PG,20,NOP,24,0,341,59,146,.404,13,58,.224,46,88,.523,.449,10,12,.833,9,30,39,49,11,1,26,17,141
300,Delon Wright\wrighde01,SG,29,ATL,34,4,598,51,117,.436,17,42,.405,34,75,.453,.509,22,26,.846,27,73,100,85,26,7,25,21,141
301,Serge Ibaka\ibakase01,C,32,LAC,22,7,346,55,114,.482,16,39,.410,39,75,.520,.553,14,21,.667,24,60,84,28,4,13,27,40,140
302,Cody Zeller\zelleco01,C,29,POR,27,0,355,51,90,.567,0,4,.000,51,86,.593,.567,38,49,.776,50,75,125,22,8,6,19,56,140
303,Jonathan Kuminga\kuminjo01,SF,19,GSW,28,2,271,51,108,.472,9,34,.265,42,74,.568,.514,27,45,.600,11,37,48,8,10,3,19,35,138
304,Thaddeus Young\youngth01,PF,33,SAS,23,0,323,65,114,.570,0,3,.000,65,111,.586,.570,8,18,.444,34,45,79,55,20,6,23,33,138
305,Taurean Prince\princta02,PF,27,MIN,29,8,437,47,127,.370,25,82,.305,22,45,.489,.469,17,22,.773,12,49,61,25,13,6,18,44,136
306,Robin Lopez\lopezro01,C,33,ORL,17,5,303,61,106,.575,0,3,.000,61,103,.592,.575,13,22,.591,37,26,63,34,1,10,23,32,135
307,Jalen Smith\smithja04,PF,21,PHO,18,4,254,49,100,.490,6,25,.240,43,75,.573,.520,31,37,.838,40,56,96,4,4,10,11,28,135
308,Trey Murphy III\murphtr02,SF,21,NOP,34,0,454,44,131,.336,33,97,.340,11,34,.324,.462,13,15,.867,21,51,72,20,10,4,11,34,134
309,Sterling Brown\brownst02,SG,26,DAL,32,3,481,48,118,.407,26,74,.351,22,44,.500,.517,9,10,.900,21,97,118,29,12,5,20,38,131
310,Luka Garza\garzalu01,C,23,DET,25,5,310,47,108,.435,12,38,.316,35,70,.500,.491,25,38,.658,45,33,78,15,8,2,15,45,131
311,Ziaire Williams\willizi02,SF,20,MEM,23,2,424,51,129,.395,22,78,.282,29,51,.569,.481,6,8,.750,6,27,33,17,11,6,13,39,130
312,Austin Reaves\reaveau01,SG,23,LAL,22,0,447,45,88,.511,18,50,.360,27,38,.711,.614,21,24,.875,7,43,50,24,7,3,12,37,129
313,Ish Smith\smithis01,PG,33,CHO,27,1,389,56,139,.403,8,18,.444,48,121,.397,.432,9,16,.563,4,35,39,75,15,7,30,27,129
314,Khem Birch\birchkh01,C,29,TOR,21,5,453,49,98,.500,0,7,.000,49,91,.538,.500,29,40,.725,56,56,112,26,18,11,15,39,127
315,Zeke Nnaji\nnajize01,PF,21,DEN,22,0,326,43,93,.462,20,43,.465,23,50,.460,.570,20,35,.571,23,45,68,8,4,7,7,36,126
316,James Johnson\johnsja01,PF,34,BRK,27,2,485,56,116,.483,7,27,.259,49,89,.551,.513,6,17,.353,24,72,96,47,12,11,17,53,125
317,Kelly Olynyk\olynyke01,C,30,DET,10,1,230,45,98,.459,14,41,.341,31,57,.544,.531,21,35,.600,13,40,53,23,14,7,15,27,125
318,Eric Paschall\pascher01,PF,25,UTA,28,1,317,41,91,.451,14,49,.286,27,42,.643,.527,28,39,.718,16,33,49,18,3,3,14,24,124
319,Nick Richards\richani01,C,24,CHO,31,5,287,50,73,.685,0,0,,50,73,.685,.685,24,29,.828,27,41,68,11,9,19,18,44,124
320,Timothé Luwawu-Cabarrot\luwawti01,SF,26,ATL,26,11,379,41,106,.387,26,73,.356,15,33,.455,.509,15,18,.833,8,35,43,21,10,3,10,39,123
321,DeAndre Jordan\jordade01,C,33,LAL,28,18,365,56,83,.675,0,0,,56,83,.675,.675,10,17,.588,44,113,157,11,10,24,19,47,122
322,Dennis Smith Jr.\smithde03,PG,24,POR,22,3,376,47,119,.395,6,25,.240,41,94,.436,.420,22,33,.667,12,40,52,73,27,9,34,25,122
323,Dalano Banton\bantoda01,SF,22,TOR,32,1,380,48,117,.410,7,26,.269,41,91,.451,.440,18,24,.750,19,47,66,55,12,5,33,41,121
324,Saben Lee\leesa01,PG,22,DET,20,0,311,43,104,.413,12,42,.286,31,62,.500,.471,23,31,.742,7,42,49,51,23,8,18,20,121
325,Isaiah Roby\robyis01,PF,23,OKC,18,5,246,47,84,.560,11,22,.500,36,62,.581,.625,16,21,.762,20,39,59,13,4,6,15,26,121
326,Lamar Stevens\stevela01,PF,24,CLE,27,5,377,49,111,.441,11,34,.324,38,77,.494,.491,12,19,.632,19,39,58,17,9,6,14,38,121
327,De'Andre Hunter\huntede01,SF,24,ATL,11,11,306,50,111,.450,15,38,.395,35,73,.479,.518,4,10,.400,4,26,30,7,7,3,14,32,119
328,Rodney Hood\hoodro01,SF,29,MIL,32,0,515,41,115,.357,23,73,.315,18,42,.429,.457,13,14,.929,11,51,62,26,11,2,7,25,118
329,Jock Landale\landajo01,C,26,SAS,22,0,207,44,76,.579,14,28,.500,30,48,.625,.671,14,16,.875,25,18,43,19,3,8,13,20,116
330,Justise Winslow\winslju01,SF,25,LAC,31,1,352,50,112,.446,5,24,.208,45,88,.511,.469,9,19,.474,18,76,94,34,17,13,28,30,114
331,Maurice Harkless\harklma01,SF,28,SAC,28,14,526,44,100,.440,16,58,.276,28,42,.667,.520,9,13,.692,5,60,65,15,12,15,18,44,113
332,Quentin Grimes\grimequ01,SG,21,NYK,23,2,311,37,97,.381,30,80,.375,7,17,.412,.536,5,8,.625,4,28,32,21,12,4,14,26,109
333,Troy Brown Jr.\browntr01,SF,22,CHI,26,1,371,41,99,.414,13,43,.302,28,56,.500,.480,12,16,.750,12,57,69,29,13,2,7,22,107
334,Enes Freedom\kanteen01,C,29,BOS,24,1,306,45,83,.542,1,4,.250,44,79,.557,.548,16,20,.800,53,76,129,4,5,11,15,30,107
335,Yuta Watanabe\watanyu01,SF,27,TOR,14,2,287,38,92,.413,19,50,.380,19,42,.452,.516,12,22,.545,13,47,60,15,6,8,11,24,107
336,Wesley Matthews\matthwe02,SG,35,MIL,15,4,305,39,78,.500,24,56,.429,15,22,.682,.654,3,6,.500,8,23,31,12,6,5,7,23,105
337,Josh Green\greenjo02,SG,21,DAL,25,0,292,43,75,.573,5,15,.333,38,60,.633,.607,13,17,.765,15,35,50,27,12,5,11,35,104
338,Gorgui Dieng\dienggo01,C,32,ATL,28,1,275,35,76,.461,16,40,.400,19,36,.528,.566,16,21,.762,26,67,93,26,8,10,16,37,102
339,Isaiah Joe\joeis01,SG,22,PHI,24,0,294,32,92,.348,23,68,.338,9,24,.375,.473,14,15,.933,3,31,34,19,5,2,7,19,101
340,PJ Dozier\doziepj01,SG,25,DEN,18,0,340,36,99,.364,15,48,.313,21,51,.412,.439,10,13,.769,14,49,63,29,11,6,13,33,97
341,Tony Bradley\bradlto01,C,24,CHI,25,7,312,44,75,.587,0,0,,44,75,.587,.587,7,9,.778,36,74,110,14,5,16,16,33,95
342,Frank Kaminsky\kaminfr01,C,28,PHO,9,0,181,36,66,.545,5,15,.333,31,51,.608,.583,18,20,.900,11,30,41,13,8,7,5,14,95
343,Kent Bazemore\bazemke01,SF,32,LAL,24,14,407,33,101,.327,18,54,.333,15,47,.319,.416,10,13,.769,8,40,48,21,20,6,8,51,94
344,Killian Tillie\tilliki02,C,23,MEM,27,3,354,34,99,.343,21,64,.328,13,35,.371,.449,5,8,.625,19,30,49,14,19,13,8,42,94
345,Danuel House Jr.\houseda01,SF,28,TOT,20,1,290,30,87,.345,14,44,.318,16,43,.372,.425,19,21,.905,6,44,50,24,6,6,19,22,93
346,Andre Iguodala\iguodan01,SF,38,GSW,20,0,416,36,87,.414,12,52,.231,24,35,.686,.483,9,12,.750,15,57,72,86,16,14,17,18,93
347,Taj Gibson\gibsota01,C,36,NYK,25,3,476,36,73,.493,4,14,.286,32,59,.542,.521,16,21,.762,41,73,114,20,12,22,17,63,92
348,Thanasis Antetokounmpo\antetth01,SF,29,MIL,27,5,327,37,81,.457,1,11,.091,36,70,.514,.463,15,24,.625,30,47,77,19,13,6,17,53,90
349,Michael Porter Jr.\portemi01,SF,23,DEN,9,9,265,37,103,.359,10,48,.208,27,55,.491,.408,5,9,.556,9,50,59,17,10,2,12,16,89
350,Tomáš Satoranský\satorto01,SG,30,NOP,31,3,462,32,103,.311,5,30,.167,27,73,.370,.335,19,25,.760,18,45,63,71,14,1,23,32,88
351,Duane Washington Jr.\washidu02,PG,21,IND,10,6,211,31,88,.352,12,43,.279,19,45,.422,.420,13,17,.765,1,17,18,19,7,1,11,9,87
352,Sandro Mamukelashvili\mamuksa01,PF,22,MIL,22,2,262,32,75,.427,13,35,.371,19,40,.475,.513,9,12,.750,26,26,52,12,6,6,9,17,86
353,Aaron Nesmith\nesmiaa01,SF,22,BOS,28,1,300,32,93,.344,15,64,.234,17,29,.586,.425,7,9,.778,8,39,47,10,8,1,17,38,86
354,Rajon Rondo\rondora01,PG,35,TOT,21,0,354,33,95,.347,14,44,.318,19,51,.373,.421,6,8,.750,11,50,61,81,15,5,41,31,86
355,Brad Wanamaker\wanambr01,PG,32,TOT,23,2,320,28,77,.364,4,17,.235,24,60,.400,.390,23,25,.920,6,33,39,55,7,6,23,45,83
356,Jevon Carter\carteje01,PG,26,BRK,31,1,359,28,99,.283,23,77,.299,5,22,.227,.399,3,4,.750,6,41,47,30,11,8,14,31,82
357,Lance Stephenson\stephla01,SF-SG,31,TOT,11,0,192,34,69,.493,8,25,.320,26,44,.591,.551,6,9,.667,3,28,31,36,5,0,12,19,82
358,Moses Brown\brownmo01,C,22,DAL,24,1,162,27,48,.563,0,0,,27,48,.563,.563,27,43,.628,15,42,57,0,3,8,14,28,81
359,Santi Aldama\aldamsa01,PF,21,MEM,22,0,240,32,85,.376,4,35,.114,28,50,.560,.400,11,19,.579,22,37,59,13,2,6,8,23,79
360,Boban Marjanović\marjabo01,C,33,DAL,16,0,95,35,56,.625,1,3,.333,34,53,.642,.634,8,16,.500,7,23,30,2,0,2,11,19,79
361,Elfrid Payton\paytoel01,PG,27,PHO,21,0,255,35,87,.402,1,5,.200,34,82,.415,.408,8,15,.533,11,33,44,40,11,2,23,24,79
362,Nathan Knight\knighna01,PF,24,MIN,21,2,179,24,45,.533,2,7,.286,22,38,.579,.556,28,40,.700,20,32,52,14,3,7,12,26,78
363,Théo Maledon\maledth01,PG,20,OKC,21,0,285,22,78,.282,8,44,.182,14,34,.412,.333,26,30,.867,8,29,37,22,10,2,18,22,78
364,Justin Robinson\robinju01,PG,24,TOT,25,0,304,28,93,.301,18,61,.295,10,32,.313,.398,4,8,.500,4,17,21,32,9,1,17,27,78
365,Skylar Mays\mayssk01,SG,24,ATL,16,5,182,31,57,.544,8,23,.348,23,34,.676,.614,7,7,1.000,5,18,23,13,7,0,6,6,77
366,Markieff Morris\morrima02,PF,32,MIA,10,0,187,32,70,.457,8,22,.364,24,48,.500,.514,5,5,1.000,13,15,28,14,3,1,12,22,77
367,KZ Okpala\okpalkz01,PF,22,MIA,21,0,244,30,69,.435,9,26,.346,21,43,.488,.500,8,11,.727,11,30,41,14,4,7,5,25,77
368,Malachi Flynn\flynnma01,PG,23,TOR,26,1,230,30,86,.349,12,44,.273,18,42,.429,.419,4,7,.571,6,22,28,25,10,3,8,23,76
369,Joshua Primo\primojo01,SG,19,SAS,17,3,229,27,69,.391,14,37,.378,13,32,.406,.493,8,10,.800,7,20,27,21,7,9,12,16,76
370,Paul Millsap\millspa01,PF,36,BRK,23,0,251,28,79,.354,6,26,.231,22,53,.415,.392,12,17,.706,25,54,79,23,5,8,10,47,74
371,Josh Okogie\okogijo01,SG,23,MIN,25,6,348,23,64,.359,8,30,.267,15,34,.441,.422,19,31,.613,23,33,56,18,16,8,15,34,73
372,Jarrett Culver\culveja01,SG,22,MEM,17,0,180,30,69,.435,5,22,.227,25,47,.532,.471,7,14,.500,5,24,29,19,9,2,4,16,72
373,Keifer Sykes\sykeske01,PG,28,IND,7,5,188,26,61,.426,10,33,.303,16,28,.571,.508,8,9,.889,2,17,19,25,4,1,10,18,70
374,CJ Elleby\ellebcj01,SF,21,POR,21,0,187,26,57,.456,10,29,.345,16,28,.571,.544,7,8,.875,13,30,43,9,5,1,10,25,69
375,Markus Howard\howarma02,SG,22,DEN,16,0,116,22,62,.355,18,46,.391,4,16,.250,.500,7,8,.875,0,5,5,5,6,0,6,11,69
376,Dylan Windler\windldy01,SF,25,CLE,26,0,271,25,58,.431,16,40,.400,9,18,.500,.569,3,4,.750,12,39,51,23,7,2,10,28,69
377,Naji Marshall\marshna01,SF,24,NOP,21,0,215,20,65,.308,3,27,.111,17,38,.447,.331,25,29,.862,14,41,55,20,9,3,20,22,68
378,Onyeka Okongwu\okongon01,C,21,ATL,7,2,161,26,35,.743,0,0,,26,35,.743,.743,14,16,.875,14,29,43,8,4,9,10,26,66
379,James Bouknight\bouknja01,SG,21,CHO,18,0,147,23,67,.343,11,28,.393,12,39,.308,.425,8,10,.800,14,13,27,14,1,0,6,12,65
380,Day'Ron Sharpe\sharpda01,PF,20,BRK,14,0,114,27,43,.628,1,3,.333,26,40,.650,.640,9,17,.529,27,22,49,2,3,6,12,20,64
381,Denzel Valentine\valende01,SG,28,CLE,22,0,204,23,62,.371,18,44,.409,5,18,.278,.516,0,0,,9,29,38,11,7,0,10,17,64
382,David Duke Jr.\dukeda01,PG,22,BRK,10,7,214,24,67,.358,3,20,.150,21,47,.447,.381,12,15,.800,23,26,49,11,7,5,6,25,63
383,Tony Snell\snellto01,SG,30,POR,28,7,347,21,59,.356,17,46,.370,4,13,.308,.500,3,3,1.000,7,33,40,16,5,4,7,32,62
384,Marquese Chriss\chrisma01,PF,24,DAL,10,0,119,26,45,.578,4,10,.400,22,35,.629,.622,5,8,.625,9,32,41,2,2,4,9,30,61
385,Jordan McLaughlin\mclaujo01,PG,25,MIN,28,2,314,21,74,.284,4,28,.143,17,46,.370,.311,15,22,.682,6,24,30,66,18,1,19,13,61
386,Vlatko Čančar\cancavl01,PF,24,DEN,14,1,152,22,39,.564,7,12,.583,15,27,.556,.654,9,12,.750,6,17,23,13,2,3,8,13,60
387,Justin Champagnie\champju01,SF,20,TOR,20,0,152,23,44,.523,5,14,.357,18,30,.600,.580,9,9,1.000,22,14,36,4,3,3,2,20,60
388,Nerlens Noel\noelne01,C,27,NYK,17,10,393,22,43,.512,0,2,.000,22,41,.537,.512,15,18,.833,37,62,99,14,18,25,15,45,59
389,Charles Bassey\bassech01,PF,21,PHI,18,0,143,24,36,.667,0,3,.000,24,33,.727,.667,8,11,.727,18,36,54,6,4,15,7,27,56
390,Davon Reed\reedda01,SG,26,DEN,13,2,220,22,49,.449,8,21,.381,14,28,.500,.531,4,5,.800,6,32,38,17,15,2,4,23,56
391,Mychal Mulder\muldemy01,PG,27,ORL,15,2,195,20,67,.299,13,46,.283,7,21,.333,.396,2,2,1.000,2,19,21,3,4,1,8,12,55
392,Kessler Edwards\edwarke02,SF,21,BRK,8,1,162,22,52,.423,10,24,.417,12,28,.429,.519,0,0,,11,26,37,9,5,5,9,9,54
393,Goga Bitadze\bitadgo01,C,22,IND,21,0,170,19,59,.322,4,28,.143,15,31,.484,.356,11,18,.611,21,25,46,3,10,11,8,31,53
394,Keon Johnson\johnske07,SG,19,LAC,15,0,135,17,51,.333,3,11,.273,14,40,.350,.363,16,21,.762,6,15,21,13,7,2,7,21,53
395,Jabari Parker\parkeja01,PF,26,BOS,12,0,112,18,38,.474,8,16,.500,10,22,.455,.579,9,9,1.000,5,23,28,6,4,1,8,13,53
396,Jared Butler\butleja02,SG,21,UTA,20,1,113,18,52,.346,10,30,.333,8,22,.364,.442,6,9,.667,1,14,15,14,4,6,16,19,52
397,Anthony Gill\gillan01,PF,29,WAS,16,0,108,18,27,.667,5,7,.714,13,20,.650,.759,10,12,.833,8,17,25,8,1,2,4,18,51
398,Hassani Gravett\graveha01,PG,25,ORL,8,3,171,18,38,.474,11,26,.423,7,12,.583,.618,3,4,.750,1,20,21,20,5,1,9,13,50
399,Moses Moody\moodymo01,SG,19,GSW,24,1,168,19,54,.352,4,30,.133,15,24,.625,.389,8,11,.727,4,21,25,7,3,4,4,11,50
400,Kyle Guy\guyky01,SG,24,MIA,5,0,101,18,35,.514,9,20,.450,9,15,.600,.643,4,5,.800,1,7,8,13,4,1,5,9,49
401,Trent Forrest\forretr01,PG,23,UTA,30,2,273,18,37,.486,1,4,.250,17,33,.515,.500,11,14,.786,9,32,41,32,5,0,24,14,48
402,Kevin Knox\knoxke01,SF,22,NYK,12,0,110,15,39,.385,10,27,.370,5,12,.417,.513,7,10,.700,7,14,21,3,2,1,5,5,47
403,Semi Ojeleye\ojelese01,PF,27,MIL,16,0,287,14,66,.212,8,38,.211,6,28,.214,.273,9,11,.818,25,32,57,5,4,5,5,26,45
404,Kyrie Irving\irvinky01,PG,29,BRK,2,2,72,18,38,.474,3,10,.300,15,28,.536,.513,5,5,1.000,1,10,11,8,4,2,6,5,44
405,Jake Layman\laymaja01,SF,27,MIN,18,1,155,17,46,.370,4,24,.167,13,22,.591,.413,6,8,.750,4,19,23,5,5,3,7,8,44
406,Paul Reed\reedpa01,C,22,PHI,19,2,179,20,42,.476,0,4,.000,20,38,.526,.476,3,6,.500,20,26,46,10,12,10,7,28,43
407,Admiral Schofield\schofad01,SF,24,ORL,10,1,156,19,36,.528,5,17,.294,14,19,.737,.597,0,1,.000,2,27,29,9,1,3,8,21,43
408,Isaiah Thomas\thomais02,PG,32,TOT,5,1,114,15,47,.319,5,25,.200,10,22,.455,.372,8,11,.727,1,7,8,10,0,2,5,12,43
409,Rodney McGruder\mcgruro01,SG,30,DET,17,0,161,17,44,.386,5,21,.238,12,23,.522,.443,3,4,.750,9,19,28,11,3,2,8,12,42
410,Chris Chiozza\chiozch01,PG,26,GSW,19,1,211,14,51,.275,11,32,.344,3,19,.158,.382,1,1,1.000,8,16,24,33,8,0,17,20,40
411,Tyler Cook\cookty01,PF,24,CHI,9,0,94,13,20,.650,0,0,,13,20,.650,.650,14,16,.875,6,15,21,3,3,1,4,14,40
412,Goran Dragić\dragigo01,PG,35,TOR,5,2,90,13,34,.382,4,14,.286,9,20,.450,.441,10,10,1.000,2,12,14,9,5,1,1,8,40
413,Stanley Johnson\johnsst04,PF,25,LAL,7,5,158,13,30,.433,4,18,.222,9,12,.750,.500,9,10,.900,3,16,19,9,8,3,3,28,39
414,Kevin Pangos\pangoke01,PG,29,CLE,18,3,157,15,45,.333,6,26,.231,9,19,.474,.400,3,4,.750,2,8,10,30,2,0,7,10,39
415,Matt Thomas\thomama02,SG,27,CHI,14,0,138,14,43,.326,9,26,.346,5,17,.294,.430,2,2,1.000,1,11,12,6,3,1,0,5,39
416,Miles McBride\mcbrimi01,PG,21,NYK,16,2,142,15,52,.288,5,27,.185,10,25,.400,.337,3,4,.750,2,12,14,19,8,1,3,15,38
417,Tim Frazier\fraziti01,PG,31,ORL,10,3,200,13,43,.302,6,17,.353,7,26,.269,.372,5,9,.556,5,14,19,33,3,1,13,24,37
418,Trevelin Queen\queentr01,SG,24,HOU,8,0,69,13,29,.448,8,22,.364,5,7,.714,.586,3,3,1.000,5,9,14,3,5,0,7,6,37
419,Cassius Stanley\stanlca01,SG,22,DET,4,1,88,13,26,.500,4,10,.400,9,16,.563,.577,6,6,1.000,4,6,10,3,3,2,5,9,36
420,Jahmi'us Ramsey\ramseja01,SG,20,SAC,15,0,83,14,34,.412,2,11,.182,12,23,.522,.441,5,10,.500,1,4,5,3,1,1,2,5,35
421,Jay Scrubb\scrubja01,SG,21,LAC,13,0,74,13,34,.382,5,17,.294,8,17,.471,.456,4,6,.667,0,7,7,7,3,3,3,4,35
422,Willie Cauley-Stein\caulewi01,C,28,DAL,18,2,177,16,35,.457,1,2,.500,15,33,.455,.471,1,2,.500,13,25,38,9,6,3,7,17,34
423,Gary Clark\clarkga01,PF,27,NOP,9,1,111,11,24,.458,10,21,.476,1,3,.333,.667,2,4,.500,6,19,25,4,3,2,3,2,34
424,Abdel Nader\naderab01,SF,28,PHO,14,0,145,12,35,.343,4,14,.286,8,21,.381,.400,6,10,.600,4,23,27,7,8,4,11,20,34
425,Trendon Watford\watfotr01,SF,21,POR,14,0,102,14,30,.467,0,0,,14,30,.467,.467,6,12,.500,8,23,31,8,2,6,6,8,34
426,Bol Bol\bolbo01,PF,22,DEN,14,0,81,15,27,.556,1,4,.250,14,23,.609,.574,2,5,.400,4,16,20,5,1,2,4,4,33
427,Ignas Brazdeikis\brazdig01,SF,23,ORL,16,0,144,12,42,.286,4,22,.182,8,20,.400,.333,5,6,.833,7,15,22,8,4,1,5,16,33
428,Patrick Williams\willipa01,PF,20,CHI,5,5,125,13,23,.565,3,6,.500,10,17,.588,.630,4,4,1.000,1,10,11,3,3,2,2,9,33
429,Alize Johnson\johnsal02,PF,25,TOT,19,0,139,14,29,.483,0,4,.000,14,25,.560,.483,4,8,.500,21,27,48,8,3,0,11,15,32
430,Joe Wieskamp\wieskjo01,SG,22,SAS,11,0,65,11,21,.524,7,15,.467,4,6,.667,.690,3,7,.429,2,3,5,3,2,2,0,5,32
431,Chaundee Brown Jr.\brownch05,SG-SF,23,TOT,5,2,104,10,32,.313,6,18,.333,4,14,.286,.406,5,6,.833,1,15,16,4,2,0,1,7,31
432,Javonte Smart\smartja01,PG,22,MIL,13,1,160,11,43,.256,4,18,.222,7,25,.280,.302,5,6,.833,4,15,19,14,4,2,9,11,31
433,Paul Watson\watsopa01,SF,27,OKC,9,3,156,12,35,.343,6,26,.231,6,9,.667,.429,1,2,.500,3,24,27,8,3,3,4,10,31
434,Elijah Hughes\hugheel01,SF,23,UTA,10,1,62,10,19,.526,7,14,.500,3,5,.600,.711,3,3,1.000,0,9,9,4,2,0,4,4,30
435,Brandon Knight\knighbr03,PG,30,DAL,3,0,54,9,20,.450,4,13,.308,5,7,.714,.550,8,8,1.000,0,7,7,8,1,0,4,5,30
436,Daishen Nix\nixda01,SG,19,HOU,8,0,67,13,20,.650,3,7,.429,10,13,.769,.725,1,3,.333,1,9,10,10,7,0,9,3,30
437,Louis King\kinglo02,SF,22,SAC,5,0,55,9,26,.346,5,16,.313,4,10,.400,.442,6,7,.857,0,8,8,1,2,0,0,8,29
438,Leandro Bolmaro\bolmale01,SF,21,MIN,23,2,184,9,32,.281,2,12,.167,7,20,.350,.313,8,9,.889,15,20,35,11,5,0,12,21,28
439,Greg Monroe\monrogr01,C,31,TOT,5,0,81,13,22,.591,0,0,,13,22,.591,.591,2,5,.400,12,19,31,12,3,5,6,9,28
440,Bismack Biyombo\biyombi01,C,29,PHO,3,0,61,11,15,.733,0,0,,11,15,.733,.733,5,8,.625,6,9,15,4,3,7,0,6,27
441,Devontae Cacok\cacokde01,PF,25,SAS,6,0,54,13,19,.684,0,0,,13,19,.684,.684,0,0,,5,15,20,2,4,5,1,8,26
442,B.J. Johnson\johnsbj01,SF,26,ORL,4,0,65,11,25,.440,4,10,.400,7,15,.467,.520,0,0,,6,9,15,0,0,1,0,4,26
443,Alfonzo McKinnie\mckinal01,SF,29,CHI,6,0,86,10,23,.435,6,14,.429,4,9,.444,.565,0,2,.000,4,5,9,3,1,2,2,8,26
444,JT Thor\thorjt01,PF,19,CHO,10,0,109,9,25,.360,3,16,.188,6,9,.667,.420,5,8,.625,5,9,14,6,4,6,4,14,26
445,Ish Wainright\wainris01,PF,27,PHO,16,0,105,10,34,.294,4,20,.200,6,14,.429,.353,2,4,.500,11,10,21,8,6,1,7,21,26
446,Jose Alvarado\alvarjo01,PG,23,NOP,13,0,89,7,26,.269,4,13,.308,3,13,.231,.346,7,11,.636,3,5,8,13,7,1,2,8,25
447,Devon Dotson\dotsode01,PG,22,CHI,8,0,67,9,16,.563,2,6,.333,7,10,.700,.625,5,8,.625,1,6,7,8,1,0,3,9,25
448,James Ennis III\ennisja01,SF,31,TOT,4,0,42,9,18,.500,3,6,.500,6,12,.500,.583,4,4,1.000,4,6,10,0,2,2,1,4,25
449,Sam Merrill\merrisa01,SG,25,MEM,6,0,58,8,24,.333,7,23,.304,1,1,1.000,.479,2,4,.500,1,6,7,4,0,0,2,3,25
450,Theo Pinson\pinsoth01,SF,26,DAL,10,0,93,8,27,.296,5,20,.250,3,7,.429,.389,4,4,1.000,0,16,16,12,4,2,2,9,25
451,Trevor Ariza\arizatr01,SF,36,LAL,7,1,116,8,14,.571,7,13,.538,1,1,1.000,.821,1,2,.500,1,21,22,7,1,1,1,3,24
452,Greg Brown III\browngr01,SF,20,POR,15,0,73,10,27,.370,0,5,.000,10,22,.455,.370,4,11,.364,7,13,20,5,2,4,5,10,24
453,Donte DiVincenzo\divindo01,SG,25,MIL,4,0,66,4,25,.160,4,17,.235,0,8,.000,.240,12,13,.923,7,14,21,2,1,0,6,5,24
454,Udonis Haslem\hasleud01,C,41,MIA,8,0,52,10,20,.500,1,2,.500,9,18,.500,.525,3,3,1.000,4,13,17,2,1,1,2,11,24
455,Chris Silva\silvach01,PF,25,TOT,6,0,64,8,13,.615,0,0,,8,13,.615,.615,8,9,.889,10,17,27,3,0,0,4,12,24
456,D.J. Wilson\wilsodj01,PF,25,TOR,3,1,48,8,11,.727,0,2,.000,8,9,.889,.727,8,10,.800,1,13,14,4,5,1,2,5,24
457,Xavier Moon\moonxa01,SG,27,LAC,5,0,69,11,30,.367,1,8,.125,10,22,.455,.383,0,0,,1,8,9,6,5,1,2,3,23
458,Cameron Oliver\oliveca01,SF,25,ATL,2,0,43,10,15,.667,1,3,.333,9,12,.750,.700,2,3,.667,2,4,6,3,1,1,0,5,23
459,Brandon Goodwin\goodwbr01,PG,26,CLE,3,0,68,10,26,.385,0,7,.000,10,19,.526,.385,2,8,.250,2,9,11,14,2,0,5,7,22
460,Wes Iwundu\iwundwe01,SF,27,ATL,3,1,82,8,18,.444,3,5,.600,5,13,.385,.528,3,4,.750,3,10,13,0,1,0,1,8,22
461,Jalen Johnson\johnsja05,PF,20,ATL,11,0,52,8,17,.471,2,6,.333,6,11,.545,.529,4,6,.667,0,13,13,1,0,0,2,3,22
462,Justin Anderson\anderju01,SF,28,TOT,6,0,77,6,19,.316,3,15,.200,3,4,.750,.395,6,7,.857,2,8,10,9,2,1,3,9,21
463,Freddie Gillespie\gillefr01,PF,24,ORL,9,2,119,9,22,.409,0,1,.000,9,21,.429,.409,3,7,.429,13,23,36,5,3,9,5,18,21
464,Ed Davis\davised01,C,32,CLE,12,2,112,9,12,.750,0,0,,9,12,.750,.750,1,6,.167,5,32,37,1,3,7,3,17,19
465,Usman Garuba\garubus01,PF,19,HOU,15,0,105,8,24,.333,2,13,.154,6,11,.545,.375,1,2,.500,9,25,34,8,7,6,3,9,19
466,Juancho Hernangómez\hernaju01,PF,26,BOS,18,0,96,5,27,.185,3,18,.167,2,9,.222,.241,6,9,.667,9,16,25,3,4,2,6,7,19
467,Derrick Walton\waltode01,PG,26,DET,3,3,108,6,26,.231,3,13,.231,3,13,.231,.288,4,4,1.000,2,8,10,21,7,4,11,8,19
468,Gabriel Deck\deckga01,PF,26,OKC,7,0,56,8,14,.571,2,4,.500,6,10,.600,.643,0,0,,1,5,6,5,1,0,2,2,18
469,Malcolm Hill\hillma01,SG,26,ATL,3,0,46,5,8,.625,3,5,.600,2,3,.667,.813,4,4,1.000,2,4,6,1,4,1,0,7,17
470,Isaiah Jackson\jacksis01,PF,20,IND,9,0,49,7,17,.412,0,0,,7,17,.412,.412,3,6,.500,6,9,15,0,2,2,1,9,17
471,Tyler Johnson\johnsty01,PG,29,TOT,6,0,91,6,20,.300,5,13,.385,1,7,.143,.425,0,0,,3,9,12,7,3,3,2,7,17
472,Klay Thompson\thompkl01,SG,31,GSW,1,1,20,7,18,.389,3,8,.375,4,10,.400,.472,0,0,,1,2,3,1,0,1,2,3,17
473,Georgios Kalaitzakis\kalaige01,SF,23,MIL,9,0,48,5,11,.455,2,4,.500,3,7,.429,.545,4,9,.444,4,4,8,0,1,1,4,8,16
474,Isaiah Todd\toddis01,PF,20,WAS,9,0,35,5,15,.333,4,10,.400,1,5,.200,.467,2,4,.500,2,7,9,1,2,2,1,1,16
475,Justin Jackson\jacksju01,SF,26,TOT,4,0,25,5,8,.625,3,5,.600,2,3,.667,.813,2,2,1.000,1,5,6,0,0,0,1,2,15
476,Jericho Sims\simsje01,PF,23,NYK,12,0,84,6,6,1.000,0,0,,6,6,1.000,1.000,3,4,.750,7,14,21,1,2,5,2,5,15
477,Petr Cornelie\cornepe01,PF,26,DEN,13,0,38,5,15,.333,1,8,.125,4,7,.571,.367,3,4,.750,7,7,14,3,1,1,4,7,14
478,Sekou Doumbouya\doumbse01,PF,21,LAL,2,0,16,5,8,.625,1,2,.500,4,6,.667,.688,3,4,.750,2,4,6,0,3,2,2,1,14
479,Aleem Ford\fordal03,SF,24,ORL,5,0,74,6,20,.300,2,15,.133,4,5,.800,.350,0,0,,2,13,15,2,1,0,4,7,14
480,Langston Galloway\gallola01,SG,30,TOT,7,0,107,6,26,.231,2,16,.125,4,10,.400,.269,0,0,,3,15,18,12,1,0,6,7,14
481,Cameron McGriff\mcgrica01,SF,24,POR,3,0,46,5,14,.357,2,6,.333,3,8,.375,.429,2,2,1.000,6,9,15,3,0,1,0,7,14
482,Marcus Garrett\garrema01,SG,23,MIA,12,0,128,5,21,.238,1,4,.250,4,17,.235,.262,2,5,.400,9,14,23,7,5,3,2,16,13
483,Tacko Fall\fallta01,C,26,CLE,11,1,59,5,12,.417,0,0,,5,12,.417,.417,2,7,.286,7,16,23,2,0,6,3,3,12
484,Haywood Highsmith\highsha01,SF,25,MIA,4,0,42,4,8,.500,4,7,.571,0,1,.000,.750,0,0,,2,3,5,0,0,1,0,3,12
485,Micah Potter\pottemi01,C,23,DET,3,0,31,5,11,.455,0,2,.000,5,9,.556,.455,2,2,1.000,4,5,9,0,1,1,1,4,12
486,Isaac Bonga\bongais01,SF,22,TOR,12,0,63,3,13,.231,1,4,.250,2,9,.222,.269,4,6,.667,4,3,7,3,7,2,2,10,11
487,Cheick Diallo\diallch01,C,25,DET,3,0,31,3,8,.375,0,0,,3,8,.375,.375,5,6,.833,4,8,12,0,1,0,1,6,11
488,Wenyen Gabriel\gabriwe01,PF,24,TOT,6,0,43,4,12,.333,1,4,.250,3,8,.375,.375,2,4,.500,5,8,13,2,1,2,1,9,11
489,RJ Nembhard Jr.\nembhrj01,SG,22,CLE,5,0,40,5,11,.455,0,1,.000,5,10,.500,.455,1,2,.500,0,2,2,10,0,0,1,2,11
490,Reggie Perry\perryre01,PF,21,POR,2,0,41,4,9,.444,1,2,.500,3,7,.429,.500,2,2,1.000,2,5,7,2,1,0,1,6,11
491,Myles Powell\powelmy01,PG,24,PHI,5,0,37,4,12,.333,1,4,.250,3,8,.375,.375,2,2,1.000,1,4,5,2,1,0,3,6,11
492,Neemias Queta\quetane01,C,22,SAC,4,0,34,4,11,.364,0,0,,4,11,.364,.364,3,4,.750,4,6,10,3,1,1,2,5,11
493,Nik Stauskas\stausni01,SG,28,MIA,2,0,24,3,8,.375,2,4,.500,1,4,.250,.500,3,4,.750,1,2,3,1,0,0,0,1,11
494,Tremont Waters\watertr01,PG,24,TOT,3,0,50,4,14,.286,2,9,.222,2,5,.400,.357,0,0,,0,4,4,7,5,0,4,4,10
495,Udoka Azubuike\azubuud01,C,22,UTA,6,1,40,4,5,.800,0,0,,4,5,.800,.800,1,2,.500,2,6,8,0,1,2,2,3,9
496,Sam Hauser\hausesa01,SF,24,BOS,7,0,31,3,11,.273,3,11,.273,0,0,,.409,0,0,,1,3,4,1,1,1,0,1,9
497,Kai Jones\joneska01,C,21,CHO,12,0,33,4,6,.667,0,1,.000,4,5,.800,.667,1,4,.250,1,5,6,2,0,0,5,2,9
498,Daniel Oturu\oturuda01,C,22,TOR,3,0,27,3,6,.500,0,1,.000,3,5,.600,.500,3,5,.600,1,4,5,0,0,2,0,1,9
499,Solomon Hill\hillso01,PF,30,ATL,13,1,139,3,20,.150,2,13,.154,1,7,.143,.200,0,0,,6,17,23,12,4,2,1,16,8
500,Brook Lopez\lopezbr01,C,33,MIL,1,1,28,3,9,.333,2,4,.500,1,5,.200,.444,0,0,,2,3,5,0,1,3,0,3,8
501,Malik Newman\newmama01,PG,24,CLE,1,0,8,3,5,.600,0,1,.000,3,4,.750,.600,2,2,1.000,0,1,1,1,0,0,1,0,8
502,Quinndary Weatherspoon\weathqu01,SG,25,GSW,3,0,16,4,4,1.000,0,0,,4,4,1.000,1.000,0,0,,0,1,1,0,1,1,1,5,8
503,Brandon Williams\willibr03,PG,22,POR,2,0,12,2,3,.667,0,0,,2,3,.667,.667,4,7,.571,0,2,2,2,0,0,0,0,8
504,Vernon Carey Jr.\careyve01,C,20,CHO,2,1,12,3,6,.500,0,0,,3,6,.500,.500,1,1,1.000,2,1,3,0,1,0,1,1,7
505,Sharife Cooper\coopesh01,PG,20,ATL,9,0,33,3,13,.231,1,5,.200,2,8,.250,.269,0,0,,0,5,5,5,0,0,5,1,7
506,Jared Harper\harpeja01,PG,24,NOP,2,0,10,3,7,.429,1,2,.500,2,5,.400,.500,0,0,,1,0,1,3,0,1,1,2,7
507,Eugene Omoruyi\omorueu01,SF,24,DAL,4,0,18,2,5,.400,1,2,.500,1,3,.333,.500,2,4,.500,2,5,7,2,0,0,0,2,7
508,Paris Bass\basspa01,SF,26,PHO,2,0,7,2,6,.333,0,2,.000,2,4,.500,.333,2,2,1.000,2,2,4,0,1,0,2,2,6
509,Keljin Blevins\blevike01,SF,26,POR,3,0,14,2,4,.500,2,3,.667,0,1,.000,.750,0,0,,0,1,1,1,0,0,2,0,6
510,Charlie Brown Jr.\brownch02,SG,24,TOT,5,0,50,2,10,.200,0,6,.000,2,4,.500,.200,2,3,.667,1,7,8,2,6,2,2,4,6
511,Jeff Dowtin\dowtije01,PG,24,TOT,5,0,31,3,7,.429,0,2,.000,3,5,.600,.429,0,0,,1,6,7,3,0,1,1,2,6
512,Bruno Fernando\fernabr01,C,23,BOS,12,0,32,3,5,.600,0,0,,3,5,.600,.600,0,0,,3,3,6,1,0,2,4,4,6
513,Malik Fitts\fittsma01,PF,24,UTA,7,0,35,2,9,.222,2,4,.500,0,5,.000,.333,0,0,,0,10,10,0,0,0,2,3,6
514,Rui Hachimura\hachiru01,PF,23,WAS,1,0,14,2,8,.250,0,3,.000,2,5,.400,.250,2,4,.500,1,2,3,1,0,0,0,1,6
515,Dakota Mathias\mathida01,SG,26,MEM,4,0,8,2,4,.500,2,4,.500,0,0,,.750,0,0,,0,2,2,0,0,0,0,1,6
516,Norvel Pelle\pelleno01,C,28,UTA,3,0,19,3,5,.600,0,0,,3,5,.600,.600,0,0,,3,3,6,0,0,1,2,1,6
517,Tre Scott\scotttr01,SF,25,CLE,2,0,11,3,6,.500,0,1,.000,3,5,.600,.500,0,0,,1,1,2,0,1,1,0,2,6
518,Craig Sword\swordcr01,SG,,WAS,3,0,19,3,4,.750,0,1,.000,3,3,1.000,.750,0,0,,0,0,0,1,4,0,1,7,6
519,Rayjon Tucker\tuckera01,SG,24,DEN,3,0,29,1,2,.500,1,2,.500,0,0,,.750,3,4,.750,1,3,4,4,1,0,0,3,6
520,Mason Jones\jonesma05,SG,23,LAL,2,0,9,2,8,.250,0,2,.000,2,6,.333,.250,1,2,.500,1,1,2,0,1,0,1,1,5
521,Juwan Morgan\morgaju01,PF,24,TOR,1,0,27,2,3,.667,1,2,.500,1,1,1.000,.833,0,0,,2,2,4,1,0,0,0,3,5
522,Miye Oni\onimi01,SG,24,UTA,16,0,44,2,9,.222,1,8,.125,1,1,1.000,.278,0,1,.000,1,6,7,5,0,0,1,7,5
523,Wayne Selden\seldewa01,SG,27,NYK,3,0,19,1,4,.250,1,2,.500,0,2,.000,.375,2,4,.500,0,1,1,1,0,0,0,1,5
524,Marko Simonovic\simonma01,C,22,CHI,5,0,16,0,7,.000,0,3,.000,0,4,.000,.000,5,6,.833,2,1,3,0,0,0,2,1,5
525,Robert Woodard II\woodaro01,SF,22,SAC,8,0,15,1,4,.250,1,1,1.000,0,3,.000,.375,2,2,1.000,0,2,2,0,0,0,1,2,5
526,Darren Collison\collida01,PG,34,LAL,3,0,37,2,7,.286,0,3,.000,2,4,.500,.286,0,0,,0,4,4,2,1,0,1,5,4
527,Damyean Dotson\dotsoda01,SG,27,NYK,2,0,21,2,4,.500,0,1,.000,2,3,.667,.500,0,0,,0,2,2,1,0,0,0,0,4
528,Shaquille Harrison\harrish01,SG,28,BRK,2,0,23,2,6,.333,0,2,.000,2,4,.500,.333,0,0,,1,3,4,3,1,1,2,3,4
529,Scotty Hopson\hopsosc01,SG,32,OKC,1,0,18,2,4,.500,0,1,.000,2,3,.667,.500,0,0,,0,1,1,1,0,0,2,1,4
530,Chandler Hutchison\hutchch01,SF,25,PHO,6,0,22,1,2,.500,0,0,,1,2,.500,.500,2,2,1.000,0,5,5,2,0,0,4,1,4
531,Carlik Jones\jonesca03,PG,24,TOT,5,0,23,1,9,.111,0,1,.000,1,8,.125,.111,2,2,1.000,1,2,3,5,1,0,3,0,4
532,Jemerrio Jones\jonesje01,SF,26,LAL,2,0,15,2,3,.667,0,0,,2,3,.667,.667,0,0,,2,1,3,0,1,0,0,2,4
533,Luke Kornet\kornelu01,C,26,TOT,3,0,18,1,6,.167,0,1,.000,1,5,.200,.167,2,3,.667,3,1,4,1,0,1,0,2,4
534,Olivier Sarr\sarrol01,C,22,OKC,2,0,14,1,3,.333,0,1,.000,1,2,.500,.333,2,2,1.000,0,5,5,0,0,2,0,1,4
535,Brodric Thomas\thomabr01,SG,25,BOS,5,0,22,1,6,.167,0,4,.000,1,2,.500,.167,2,2,1.000,1,3,4,3,0,0,2,0,4
536,Rob Edwards\edwarro01,SG,25,OKC,2,0,11,1,4,.250,1,4,.250,0,0,,.375,0,0,,0,3,3,0,0,0,1,0,3
537,Emmanuel Mudiay\mudiaem01,PG,25,SAC,2,0,11,0,2,.000,0,0,,0,2,.000,.000,3,4,.750,0,0,0,4,1,0,1,1,3
538,Jamorko Pickett\pickeja01,PF,24,DET,6,0,47,1,10,.100,1,7,.143,0,3,.000,.150,0,0,,2,7,9,1,0,1,3,3,3
539,Yves Pons\ponsyv01,SF,22,MEM,6,0,21,1,3,.333,1,1,1.000,0,2,.000,.500,0,2,.000,2,3,5,0,0,0,0,2,3
540,Deividas Sirvydis\sirvyde01,SG,21,DET,3,0,27,1,10,.100,1,7,.143,0,3,.000,.150,0,0,,0,6,6,1,3,1,0,4,3
541,McKinley Wright IV\wrighmc01,PG,23,MIN,1,0,4,1,1,1.000,1,1,1.000,0,0,,1.500,0,0,,0,0,0,0,0,0,1,0,3
542,Joel Ayayi\ayayijo01,SG,21,WAS,7,0,20,1,6,.167,0,1,.000,1,5,.200,.167,0,0,,1,2,3,4,0,0,0,0,2
543,Shaq Buchanan\buchash01,PG,25,MEM,2,0,10,1,4,.250,0,2,.000,1,2,.500,.250,0,0,,1,1,2,2,1,0,2,1,2
544,Ahmad Caver\caverah01,PG,25,IND,1,0,1,1,1,1.000,0,0,,1,1,1.000,1.000,0,0,,0,0,0,0,0,0,0,0,2
545,Jarron Cumberland\cumbeja01,SG,24,POR,3,0,12,1,2,.500,0,1,.000,1,1,1.000,.500,0,0,,1,2,3,1,0,0,0,2,2
546,Aaron Henry\henryaa01,SF,22,PHI,6,0,17,1,5,.200,0,1,.000,1,4,.250,.200,0,0,,0,1,1,0,0,2,2,2,2
547,DaQuan Jeffries\jeffrda01,SG,24,MEM,3,0,9,1,2,.500,0,1,.000,1,1,1.000,.500,0,0,,0,2,2,1,0,0,0,1,2
548,Joe Johnson\johnsjo02,SG,40,BOS,1,0,2,1,1,1.000,0,0,,1,1,1.000,1.000,0,0,,0,0,0,0,0,0,0,0,2
549,Braxton Key\keybr01,SF,24,PHI,2,0,6,1,2,.500,0,1,.000,1,1,1.000,.500,0,0,,1,1,2,1,1,0,2,1,2
550,Vit Krejci\krejcvi01,SG,21,OKC,3,0,9,0,2,.000,0,2,.000,0,0,,.000,2,2,1.000,0,3,3,0,0,0,1,0,2
551,Mac McClung\mccluma01,PG,23,CHI,1,0,3,1,1,1.000,0,0,,1,1,1.000,1.000,0,0,,0,0,0,0,0,0,1,0,2
552,Jaylen Morris\morrija01,SG,26,SAS,3,0,16,0,6,.000,0,2,.000,0,4,.000,.000,2,4,.500,0,2,2,2,0,0,1,2,2
553,Jaden Springer\sprinja01,SG,19,PHI,2,0,6,1,1,1.000,0,0,,1,1,1.000,1.000,0,0,,1,1,2,0,0,2,1,0,2
554,Tyrell Terry\terryty01,PG,21,MEM,2,0,3,1,1,1.000,0,0,,1,1,1.000,1.000,0,0,,0,0,0,0,0,0,0,1,2
555,Cassius Winston\winstca01,PG,23,WAS,2,0,7,0,2,.000,0,2,.000,0,0,,.000,2,2,1.000,0,0,0,2,0,0,1,0,2
556,George King\kingge03,SF,28,DAL,4,0,19,0,5,.000,0,4,.000,0,1,.000,.000,1,2,.500,0,5,5,0,0,0,1,4,1
557,Scottie Lewis\lewissc01,SG,21,CHO,2,0,7,0,0,,0,0,,0,0,,,1,2,.500,0,0,0,1,1,0,0,0,1
558,Cat Barber\barbeca01,PG,27,ATL,3,0,13,0,4,.000,0,0,,0,4,.000,.000,0,4,.000,1,2,3,3,0,0,1,1,0
559,Jordan Bell\belljo01,C,27,CHI,1,0,2,0,0,,0,0,,0,0,,,0,0,,1,0,1,0,1,0,0,2,0
560,Sam Dekker\dekkesa01,PF,27,TOR,1,0,1,0,0,,0,0,,0,0,,,0,0,,0,0,0,0,0,0,0,0,0
561,Javin DeLaurier\delauja01,C,23,MIL,1,0,3,0,0,,0,0,,0,0,,,0,0,,0,1,1,0,1,0,0,1,0
562,Jaime Echenique\echenja01,C,24,WAS,1,0,3,0,0,,0,0,,0,0,,,0,0,,0,0,0,0,0,0,0,0,0
563,Jordan Goodwin\goodwjo01,SG,23,WAS,2,0,6,0,3,.000,0,1,.000,0,2,.000,.000,0,0,,0,1,1,0,0,0,0,1,0
564,Tyler Hall\hallty01,SG,24,NYK,1,0,2,0,0,,0,0,,0,0,,,0,0,,0,0,0,0,0,0,0,0,0
565,Nate Hinton\hintona01,SG,22,IND,2,0,2,0,1,.000,0,0,,0,1,.000,.000,0,0,,0,0,0,0,0,0,1,0,0
566,Jaylen Hoard\hoardja01,SF,22,OKC,1,0,2,0,1,.000,0,0,,0,1,.000,.000,0,0,,1,1,2,0,0,0,0,0,0
567,Jay Huff\huffja01,C,23,LAL,4,0,20,0,3,.000,0,2,.000,0,1,.000,.000,0,0,,1,3,4,1,1,1,1,1,0
568,DeJon Jarreau\jarrede01,SG,24,IND,1,0,1,0,0,,0,0,,0,0,,,0,0,,0,0,0,0,0,0,0,0,0
569,David Johnson\johnsda08,SG,20,TOR,2,0,2,0,1,.000,0,1,.000,0,0,,.000,0,0,,0,0,0,0,0,0,0,0,0
570,Arnoldas Kulboka\kulboar01,SF,24,CHO,1,0,3,0,0,,0,0,,0,0,,,0,0,,0,0,0,0,0,0,0,0,0
571,Anthony Lamb\lamban01,SF,24,SAS,2,0,8,0,2,.000,0,2,.000,0,0,,.000,0,0,,0,1,1,2,0,0,0,0,0
572,Isaiah Livers\liveris01,SF,23,DET,1,0,5,0,2,.000,0,2,.000,0,0,,.000,0,0,,0,0,0,0,1,1,1,1,0
573,Didi Louzada\louzama01,SF,22,NOP,2,0,7,0,3,.000,0,3,.000,0,0,,.000,0,0,,2,0,2,1,0,0,0,0,0
574,JaQuori McLaughlin\mclauja01,PG,24,DAL,4,0,11,0,2,.000,0,1,.000,0,1,.000,.000,0,0,,0,0,0,2,0,0,0,1,0
575,C.J. Miles\milescj01,SG,34,BOS,1,0,2,0,0,,0,0,,0,0,,,0,0,,0,0,0,0,0,0,0,1,0
576,Matt Mooney\moonema01,SG,24,NYK,1,0,2,0,1,.000,0,1,.000,0,0,,.000,0,0,,0,0,0,0,1,0,1,0,0
577,Ade Murkey\murkead01,SG,24,SAC,1,0,1,0,0,,0,0,,0,0,,,0,0,,0,0,0,0,0,0,0,0,0
578,Jaysean Paige\paigeja01,PG,27,DET,1,0,7,0,3,.000,0,2,.000,0,1,.000,.000,0,0,,0,1,1,1,0,0,1,2,0
579,Trayvon Palmer\palmetr01,SG,27,DET,1,0,17,0,1,.000,0,0,,0,1,.000,.000,0,0,,0,2,2,0,0,0,1,2,0
580,Jordan Schakel\schakjo01,SG,23,WAS,2,0,14,0,6,.000,0,3,.000,0,3,.000,.000,0,0,,2,1,3,0,0,0,0,0,0
581,Xavier Sneed\sneedxa01,SF,24,MEM,2,0,8,0,2,.000,0,2,.000,0,0,,.000,0,0,,1,1,2,0,0,0,0,2,0
582,Terry Taylor\taylote01,SG,22,IND,1,0,1,0,0,,0,0,,0,0,,,0,0,,0,0,0,1,0,0,0,0,0
583,Emanuel Terry\terryem01,PF,25,PHO,3,0,18,0,5,.000,0,0,,0,5,.000,.000,0,0,,8,7,15,2,1,0,5,4,0
584,Jon Teske\teskejo01,C,24,MEM,3,0,8,0,1,.000,0,0,,0,1,.000,.000,0,2,.000,0,2,2,1,1,0,0,1,0
585,M.J. Walker\walkemj01,SG,23,PHO,2,0,8,0,4,.000,0,2,.000,0,2,.000,.000,0,0,,0,1,1,1,2,0,0,1,0
586,Moses Wright\wrighmo01,PF,23,LAC,1,0,1,0,0,,0,0,,0,0,,,0,0,,0,0,0,1,0,0,0,0,0